AAAAACAGGCTCATATGCCCAACT -> AAAACAGGCTCATATGCCCAACTG
AAAAACCACACCCCGCAATTCTAC -> AAAACCACACCCCGCAATTCTACT
AAAAAGAGTGTATCATCGAACAGT -> AAAAGAGTGTATCATCGAACAGTC
AAAACAGGCTCATATGCCCAACTG -> AAACAGGCTCATATGCCCAACTGG
AAAACATCTTGTCCTGTTAAATTC -> AAACATCTTGTCCTGTTAAATTCC
AAAACCACACCCCGCAATTCTACT -> AAACCACACCCCGCAATTCTACTC
AAAACCCCTGACCTAAGACTGGAC -> AAACCCCTGACCTAAGACTGGACC
AAAACGCCGGTTGTCCAGGAAGAT -> AAACGCCGGTTGTCCAGGAAGATT
AAAACTTACGCACAGAACGGAGTC -> AAACTTACGCACAGAACGGAGTCC
AAAAGAAGTCGAGGCCTTCGATAA -> AAAGAAGTCGAGGCCTTCGATAAA
AAAAGAGTGTATCATCGAACAGTC -> AAAGAGTGTATCATCGAACAGTCA
AAAATATCAACTGGACCACGTCAC -> AAATATCAACTGGACCACGTCACC
AAAATCCCTTAATAGAAAATTAAA -> AAATCCCTTAATAGAAAATTAAAA
AAAATCTCCTGGGAGCATCACGAC -> AAATCTCCTGGGAGCATCACGACA
AAAATTAAAACATCTTGTCCTGTT -> AAATTAAAACATCTTGTCCTGTTA
AAACAGGCTCATATGCCCAACTGG -> AACAGGCTCATATGCCCAACTGGT
AAACATCATTCTTATTTCAGGCCC -> AACATCATTCTTATTTCAGGCCCC
AAACATCTTGTCCTGTTAAATTCC -> AACATCTTGTCCTGTTAAATTCCA
AAACCACACCCCGCAATTCTACTC -> AACCACACCCCGCAATTCTACTCT
AAACCACGCTATTTGTTCAACAAG -> AACCACGCTATTTGTTCAACAAGA
AAACCCCTGACCTAAGACTGGACC -> AACCCCTGACCTAAGACTGGACCT
AAACCCGTGTATTGACACTCTGAC -> AACCCGTGTATTGACACTCTGACA
AAACGCCGGTTGTCCAGGAAGATT -> AACGCCGGTTGTCCAGGAAGATTG
AAACTCCATAAAAACCACACCCCG -> AACTCCATAAAAACCACACCCCGC
AAACTGGCCTTAACATGACGTCGT -> AACTGGCCTTAACATGACGTCGTG
AAACTTACGCACAGAACGGAGTCC -> AACTTACGCACAGAACGGAGTCCA
AAAGAAAGCTCTCTAAACCACGCT -> AAGAAAGCTCTCTAAACCACGCTA
AAAGAAGTCGAGGCCTTCGATAAA -> AAGAAGTCGAGGCCTTCGATAAAA
AAAGAAGTCTCACGTGACCCCAGG -> AAGAAGTCTCACGTGACCCCAGGG
AAAGAGTGTATCATCGAACAGTCA -> AAGAGTGTATCATCGAACAGTCAC
AAAGATATAAACTCCATAAAAACC -> AAGATATAAACTCCATAAAAACCA
AAAGCTCTCTAAACCACGCTATTT -> AAGCTCTCTAAACCACGCTATTTG
AAAGCTTATTTCTTCTGGAACGCC -> AAGCTTATTTCTTCTGGAACGCCA
AAAGGTATGAGCGTTCCTGGTGGT -> AAGGTATGAGCGTTCCTGGTGGTG
AAATAGTAGGATAGCTTATGTTGC -> AATAGTAGGATAGCTTATGTTGCC
AAATATCAACTGGACCACGTCACC -> AATATCAACTGGACCACGTCACCG
AAATCATATCACTAACCACCGGAC -> AATCATATCACTAACCACCGGACA
AAATCCCTTAATAGAAAATTAAAA -> AATCCCTTAATAGAAAATTAAAAC
AAATCTCCTGGGAGCATCACGACA -> AATCTCCTGGGAGCATCACGACAC
AAATTAAAACATCTTGTCCTGTTA -> AATTAAAACATCTTGTCCTGTTAA
AAATTCCAGCACGGCCTCTGTGGG -> AATTCCAGCACGGCCTCTGTGGGG
AACAAGAAGTGAAGCAGGTTCCAT -> ACAAGAAGTGAAGCAGGTTCCATA
AACAAGGTGACTCCTTCATGGTTG -> ACAAGGTGACTCCTTCATGGTTGC
AACACCATCGGGGTAGCTACACAC -> ACACCATCGGGGTAGCTACACACA
AACAGATGACTCGAGGCCCTTCGC -> ACAGATGACTCGAGGCCCTTCGCT
AACAGGCTCATATGCCCAACTGGT -> ACAGGCTCATATGCCCAACTGGTC
AACAGTCACATGCGATATTCCCGC -> ACAGTCACATGCGATATTCCCGCC
AACATCATTCTTATTTCAGGCCCC -> ACATCATTCTTATTTCAGGCCCCA
AACATCGGGTTGGTACGATTGCTA -> ACATCGGGTTGGTACGATTGCTAG
AACATCTTGTCCTGTTAAATTCCA -> ACATCTTGTCCTGTTAAATTCCAG
AACATGACGTCGTGGAAGTTCTAA -> ACATGACGTCGTGGAAGTTCTAAA
AACATTGGAGTTGCTCGCTTATTC -> ACATTGGAGTTGCTCGCTTATTCG
AACCACACCCCGCAATTCTACTCT -> ACCACACCCCGCAATTCTACTCTC
AACCACCGGACAAAGGTATGAGCG -> ACCACCGGACAAAGGTATGAGCGT
AACCACGCTATTTGTTCAACAAGA -> ACCACGCTATTTGTTCAACAAGAA
AACCACGCTTGTATAGACCGGCCG -> ACCACGCTTGTATAGACCGGCCGC
AACCCCTGACCTAAGACTGGACCT -> ACCCCTGACCTAAGACTGGACCTT
AACCCGTGTATTGACACTCTGACA -> ACCCGTGTATTGACACTCTGACAC
AACCGGGGAACAAGGTGACTCCTT -> ACCGGGGAACAAGGTGACTCCTTC
AACCGTCTTTAGCCTAGTTAGGCA -> ACCGTCTTTAGCCTAGTTAGGCAA
AACCTCACTAACGCGTCCGCAAAT -> ACCTCACTAACGCGTCCGCAAATA
AACCTTCATAGGACTAGGACGCCG -> ACCTTCATAGGACTAGGACGCCGG
AACGACGGGGATGAGTGCGACCCT -> ACGACGGGGATGAGTGCGACCCTT
AACGCATGTAACGTATCCTTGGAT -> ACGCATGTAACGTATCCTTGGATA
AACGCCATTATTTTTAGGCCTCGT -> ACGCCATTATTTTTAGGCCTCGTC
AACGCCGGTTGTCCAGGAAGATTG -> ACGCCGGTTGTCCAGGAAGATTGT
AACGCGTCCGCAAATAGTAGGATA -> ACGCGTCCGCAAATAGTAGGATAG
AACGCTTGATATCTCTAGGTTACG -> ACGCTTGATATCTCTAGGTTACGC
AACGGAGTCCACACGTGCCCAATC -> ACGGAGTCCACACGTGCCCAATCG
AACGTATCCTTGGATACCCATGAT -> ACGTATCCTTGGATACCCATGATA
AACGTCAATATCATTTTAACTCGC -> ACGTCAATATCATTTTAACTCGCT
AACTAATGACCCTCGGGTTCCCCA -> ACTAATGACCCTCGGGTTCCCCAG
AACTATCGCAAAACCCCTGACCTA -> ACTATCGCAAAACCCCTGACCTAA
AACTATCTTCATTACCAGTAGTCT -> ACTATCTTCATTACCAGTAGTCTA
AACTATGTCGTGTCCAGCTCAGAG -> ACTATGTCGTGTCCAGCTCAGAGT
AACTCCATAAAAACCACACCCCGC -> ACTCCATAAAAACCACACCCCGCA
AACTCGCTGCAGCAGTTCTTACCG -> ACTCGCTGCAGCAGTTCTTACCGT
AACTGGACCACGTCACCGGTGCTT -> ACTGGACCACGTCACCGGTGCTTG
AACTGGCCTTAACATGACGTCGTG -> ACTGGCCTTAACATGACGTCGTGG
AACTGGTCAGCGGATCGATTAATC -> ACTGGTCAGCGGATCGATTAATCT
AACTTAACGCTTGATATCTCTAGG -> ACTTAACGCTTGATATCTCTAGGT
AACTTACGCACAGAACGGAGTCCA -> ACTTACGCACAGAACGGAGTCCAC
AACTTAGCAGCACACTGAGGTTAG -> ACTTAGCAGCACACTGAGGTTAGT
AACTTGTACAAAACTTACGCACAG -> ACTTGTACAAAACTTACGCACAGA
AACTTTACGCTCTGCGGGGGACAT -> ACTTTACGCTCTGCGGGGGACATT
AAGAAAGCTCTCTAAACCACGCTA -> AGAAAGCTCTCTAAACCACGCTAT
AAGAAGTCGAGGCCTTCGATAAAA -> AGAAGTCGAGGCCTTCGATAAAAT
AAGAAGTCTCACGTGACCCCAGGG -> AGAAGTCTCACGTGACCCCAGGGA
AAGAAGTGAAGCAGGTTCCATAAA -> AGAAGTGAAGCAGGTTCCATAAAC
AAGACAGCTATCCTGACATTGATT -> AGACAGCTATCCTGACATTGATTG
AAGACTGGACCTTCTATCGGCTGA -> AGACTGGACCTTCTATCGGCTGAA
AAGACTTGCCTCACAATCCGTGTG -> AGACTTGCCTCACAATCCGTGTGA
AAGAGTGTATCATCGAACAGTCAC -> AGAGTGTATCATCGAACAGTCACA
AAGATATAAACTCCATAAAAACCA -> AGATATAAACTCCATAAAAACCAC
AAGATTGTGGAAGTAAAGAAAGCT -> AGATTGTGGAAGTAAAGAAAGCTC
AAGCAGGTTCCATAAACATCATTC -> AGCAGGTTCCATAAACATCATTCT
AAGCGCACGAAGTCGTCATCCCGT -> AGCGCACGAAGTCGTCATCCCGTC
AAGCTCCGCAAAAAGAGTGTATCA -> AGCTCCGCAAAAAGAGTGTATCAT
AAGCTCTCTAAACCACGCTATTTG -> AGCTCTCTAAACCACGCTATTTGT
AAGCTCTTGGAGAACCTCACTAAC -> AGCTCTTGGAGAACCTCACTAACG
AAGCTGGCTCAGAATCTGCTACAT -> AGCTGGCTCAGAATCTGCTACATC
AAGCTTATTTCTTCTGGAACGCCA -> AGCTTATTTCTTCTGGAACGCCAT
AAGGTATGAGCGTTCCTGGTGGTG -> AGGTATGAGCGTTCCTGGTGGTGG
AAGGTGACTCCTTCATGGTTGCTT -> AGGTGACTCCTTCATGGTTGCTTT
AAGTAAAATCTCCTGGGAGCATCA -> AGTAAAATCTCCTGGGAGCATCAC
AAGTAAAGAAAGCTCTCTAAACCA -> AGTAAAGAAAGCTCTCTAAACCAC
AAGTCAACACCATCGGGGTAGCTA -> AGTCAACACCATCGGGGTAGCTAC
AAGTCGAGGCCTTCGATAAAATAT -> AGTCGAGGCCTTCGATAAAATATC
AAGTCGTCATCCCGTCGTGAACTA -> AGTCGTCATCCCGTCGTGAACTAT
AAGTCTACTATCTGATCCGAGCTG -> AGTCTACTATCTGATCCGAGCTGG
AAGTCTCACGTGACCCCAGGGACC -> AGTCTCACGTGACCCCAGGGACCT
AAGTGAAGCAGGTTCCATAAACAT -> AGTGAAGCAGGTTCCATAAACATC
AAGTGGACGGATCCATGCTGTCTT -> AGTGGACGGATCCATGCTGTCTTG
AAGTGGGGTAGGCCAACGTCAATA -> AGTGGGGTAGGCCAACGTCAATAT
AAGTTCTAAATCATATCACTAACC -> AGTTCTAAATCATATCACTAACCA
AAGTTGAATCTAGTCTTTCTTCAG -> AGTTGAATCTAGTCTTTCTTCAGT
AATAACTTGTACAAAACTTACGCA -> ATAACTTGTACAAAACTTACGCAC
AATAAGTGGACGGATCCATGCTGT -> ATAAGTGGACGGATCCATGCTGTC
AATACAATCCGGCTTATGACCATC -> ATACAATCCGGCTTATGACCATCA
AATACGGAGCTAGCGTTCTGCCGA -> ATACGGAGCTAGCGTTCTGCCGAC
AATAGAAAATTAAAACATCTTGTC -> ATAGAAAATTAAAACATCTTGTCC
AATAGACTATCCCGTGGTGTGTAT -> ATAGACTATCCCGTGGTGTGTATA
AATAGTAGGATAGCTTATGTTGCC -> ATAGTAGGATAGCTTATGTTGCCG
AATATCAACTGGACCACGTCACCG -> ATATCAACTGGACCACGTCACCGG
AATATCATTTTAACTCGCTGCAGC -> ATATCATTTTAACTCGCTGCAGCA
AATATCCGGTGTCCGACTGTGCCT -> ATATCCGGTGTCCGACTGTGCCTC
AATCATATCACTAACCACCGGACA -> ATCATATCACTAACCACCGGACAA
AATCCCTTAATAGAAAATTAAAAC -> ATCCCTTAATAGAAAATTAAAACA
AATCCGGCTTATGACCATCACTCC -> ATCCGGCTTATGACCATCACTCCA
AATCCGTGTGAACAGATGACTCGA -> ATCCGTGTGAACAGATGACTCGAG
AATCGCGATACACCCAGGTTATCA -> ATCGCGATACACCCAGGTTATCAC
AATCTAGTCTTTCTTCAGTTCGTA -> ATCTAGTCTTTCTTCAGTTCGTAA
AATCTATTGTACCTTTTTACACGA -> ATCTATTGTACCTTTTTACACGAC
AATCTCCTGGGAGCATCACGACAC -> ATCTCCTGGGAGCATCACGACACT
AATCTCGCGGAGGTGCAAAGCTTA -> ATCTCGCGGAGGTGCAAAGCTTAT
AATCTGCTACATCCCCCGCATATT -> ATCTGCTACATCCCCCGCATATTA
AATGACCCTCGGGTTCCCCAGGCC -> ATGACCCTCGGGTTCCCCAGGCCC
AATTAAAACATCTTGTCCTGTTAA -> ATTAAAACATCTTGTCCTGTTAAA
AATTAGTGGCTGACGAGTGTCTTA -> ATTAGTGGCTGACGAGTGTCTTAA
AATTCCAGCACGGCCTCTGTGGGG -> ATTCCAGCACGGCCTCTGTGGGGC
AATTCTACTCTCATAGAAAAACAG -> ATTCTACTCTCATAGAAAAACAGG
ACAAAACTTACGCACAGAACGGAG -> CAAAACTTACGCACAGAACGGAGT
ACAAAGATATAAACTCCATAAAAA -> CAAAGATATAAACTCCATAAAAAC
ACAAAGGTATGAGCGTTCCTGGTG -> CAAAGGTATGAGCGTTCCTGGTGG
ACAACATCGGGTTGGTACGATTGC -> CAACATCGGGTTGGTACGATTGCT
ACAAGAAGTGAAGCAGGTTCCATA -> CAAGAAGTGAAGCAGGTTCCATAA
ACAAGCTCTTGGAGAACCTCACTA -> CAAGCTCTTGGAGAACCTCACTAA
ACAAGGTGACTCCTTCATGGTTGC -> CAAGGTGACTCCTTCATGGTTGCT
ACAATCCGGCTTATGACCATCACT -> CAATCCGGCTTATGACCATCACTC
ACAATCCGTGTGAACAGATGACTC -> CAATCCGTGTGAACAGATGACTCG
ACACACATGACCATTGACTCATCG -> CACACATGACCATTGACTCATCGC
ACACACGAGCGGTGTGCGGGAGAC -> CACACGAGCGGTGTGCGGGAGACT
ACACAGTCTATCCGACACCATACA -> CACAGTCTATCCGACACCATACAA
ACACATGACCATTGACTCATCGCT -> CACATGACCATTGACTCATCGCTC
ACACCAAGCGCACGAAGTCGTCAT -> CACCAAGCGCACGAAGTCGTCATC
ACACCATACAAAGATATAAACTCC -> CACCATACAAAGATATAAACTCCA
ACACCATCGGGGTAGCTACACACA -> CACCATCGGGGTAGCTACACACAT
ACACCCAGGTTATCACGATGCACC -> CACCCAGGTTATCACGATGCACCA
ACACCCCGCAATTCTACTCTCATA -> CACCCCGCAATTCTACTCTCATAG
ACACCTTTGCTGCCGACTACTCTC -> CACCTTTGCTGCCGACTACTCTCT
ACACGACATGTCCGAGAACTATGT -> CACGACATGTCCGAGAACTATGTC
ACACGAGCGGTGTGCGGGAGACTA -> CACGAGCGGTGTGCGGGAGACTAA
ACACGCGTCTTACTGGATTGAGAC -> CACGCGTCTTACTGGATTGAGACT
ACACGTGCCCAATCGCGATACACC -> CACGTGCCCAATCGCGATACACCC
ACACTCTGACACTTAAAACGCCGG -> CACTCTGACACTTAAAACGCCGGT
ACACTGAACGCATGTAACGTATCC -> CACTGAACGCATGTAACGTATCCT
ACACTGAGGTTAGTGTCCGCAGAA -> CACTGAGGTTAGTGTCCGCAGAAC
ACACTTAAAACGCCGGTTGTCCAG -> CACTTAAAACGCCGGTTGTCCAGG
ACAGAACGGAGTCCACACGTGCCC -> CAGAACGGAGTCCACACGTGCCCA
ACAGATGACTCGAGGCCCTTCGCT -> CAGATGACTCGAGGCCCTTCGCTA
ACAGCTATCCTGACATTGATTGGC -> CAGCTATCCTGACATTGATTGGCA
ACAGGCTCATATGCCCAACTGGTC -> CAGGCTCATATGCCCAACTGGTCA
ACAGTCACATGCGATATTCCCGCC -> CAGTCACATGCGATATTCCCGCCG
ACAGTCTATCCGACACCATACAAA -> CAGTCTATCCGACACCATACAAAG
ACATCATTCTTATTTCAGGCCCCA -> CATCATTCTTATTTCAGGCCCCAG
ACATCCCCCGCATATTACCTCTCG -> CATCCCCCGCATATTACCTCTCGA
ACATCGGGTTGGTACGATTGCTAG -> CATCGGGTTGGTACGATTGCTAGC
ACATCTTGTCCTGTTAAATTCCAG -> CATCTTGTCCTGTTAAATTCCAGC
ACATGACCATTGACTCATCGCTCG -> CATGACCATTGACTCATCGCTCGA
ACATGACGTCGTGGAAGTTCTAAA -> CATGACGTCGTGGAAGTTCTAAAT
ACATGCGATATTCCCGCCGTCCTT -> CATGCGATATTCCCGCCGTCCTTG
ACATGTCCGAGAACTATGTCGTGT -> CATGTCCGAGAACTATGTCGTGTC
ACATTGATTGGCAAGTAAAATCTC -> CATTGATTGGCAAGTAAAATCTCC
ACATTGGACACACGAGCGGTGTGC -> CATTGGACACACGAGCGGTGTGCG
ACATTGGAGTTGCTCGCTTATTCG -> CATTGGAGTTGCTCGCTTATTCGA
ACATTTATCCCAGTCCGATCCGAA -> CATTTATCCCAGTCCGATCCGAAT
ACCAAGACTTGCCTCACAATCCGT -> CCAAGACTTGCCTCACAATCCGTG
ACCAAGCGCACGAAGTCGTCATCC -> CCAAGCGCACGAAGTCGTCATCCC
ACCACACCCCGCAATTCTACTCTC -> CCACACCCCGCAATTCTACTCTCA
ACCACCGGACAAAGGTATGAGCGT -> CCACCGGACAAAGGTATGAGCGTT
ACCACGCTATTTGTTCAACAAGAA -> CCACGCTATTTGTTCAACAAGAAG
ACCACGCTTGTATAGACCGGCCGC -> CCACGCTTGTATAGACCGGCCGCA
ACCACGTACCTTATTAAAATCCCT -> CCACGTACCTTATTAAAATCCCTT
ACCACGTCACCGGTGCTTGACGGT -> CCACGTCACCGGTGCTTGACGGTT
ACCAGTAGTCTAGTAATAGACTAT -> CCAGTAGTCTAGTAATAGACTATC
ACCATACAAAGATATAAACTCCAT -> CCATACAAAGATATAAACTCCATA
ACCATCACTCCAAGCCCCCGCATT -> CCATCACTCCAAGCCCCCGCATTT
ACCATCGGGGTAGCTACACACATG -> CCATCGGGGTAGCTACACACATGA
ACCATGTCTTTACGATGCGCCAAC -> CCATGTCTTTACGATGCGCCAACT
ACCATTGACTCATCGCTCGATAAC -> CCATTGACTCATCGCTCGATAACC
ACCATTGGGCACTGTCCCCGCTAT -> CCATTGGGCACTGTCCCCGCTATC
ACCCAATACAATCCGGCTTATGAC -> CCCAATACAATCCGGCTTATGACC
ACCCAGGTTATCACGATGCACCAA -> CCCAGGTTATCACGATGCACCAAG
ACCCATGATACACGCGTCTTACTG -> CCCATGATACACGCGTCTTACTGG
ACCCCAGGGACCTTACGGCAGGCT -> CCCCAGGGACCTTACGGCAGGCTC
ACCCCGCAATTCTACTCTCATAGA -> CCCCGCAATTCTACTCTCATAGAA
ACCCCTGACCTAAGACTGGACCTT -> CCCCTGACCTAAGACTGGACCTTC
ACCCGTGTATTGACACTCTGACAC -> CCCGTGTATTGACACTCTGACACT
ACCCTCGGGTTCCCCAGGCCCTTC -> CCCTCGGGTTCCCCAGGCCCTTCG
ACCCTTGTAATATCCGGTGTCCGA -> CCCTTGTAATATCCGGTGTCCGAC
ACCGGACAAAGGTATGAGCGTTCC -> CCGGACAAAGGTATGAGCGTTCCT
ACCGGCCGCACGTCACGGACCCAA -> CCGGCCGCACGTCACGGACCCAAT
ACCGGGGAACAAGGTGACTCCTTC -> CCGGGGAACAAGGTGACTCCTTCA
ACCGGTGCTTGACGGTTACCTTGC -> CCGGTGCTTGACGGTTACCTTGCC
ACCGTCTTTAGCCTAGTTAGGCAA -> CCGTCTTTAGCCTAGTTAGGCAAC
ACCGTTAGGATCACTTGTGTAAGT -> CCGTTAGGATCACTTGTGTAAGTC
ACCTAAGACTGGACCTTCTATCGG -> CCTAAGACTGGACCTTCTATCGGC
ACCTACATTTATCCCAGTCCGATC -> CCTACATTTATCCCAGTCCGATCC
ACCTCACTAACGCGTCCGCAAATA -> CCTCACTAACGCGTCCGCAAATAG
ACCTCTCGAGGCGAGATACCACGT -> CCTCTCGAGGCGAGATACCACGTA
ACCTTACGGCAGGCTCTTCCAATA -> CCTTACGGCAGGCTCTTCCAATAC
ACCTTATTAAAATCCCTTAATAGA -> CCTTATTAAAATCCCTTAATAGAA
ACCTTCATAGGACTAGGACGCCGG -> CCTTCATAGGACTAGGACGCCGGA
ACCTTCTATCGGCTGAACTTTACG -> CCTTCTATCGGCTGAACTTTACGC
ACCTTGCCCCCCGGAGGTCGATCG -> CCTTGCCCCCCGGAGGTCGATCGG
ACCTTTGCTGCCGACTACTCTCTT -> CCTTTGCTGCCGACTACTCTCTTA
ACCTTTTTACACGACATGTCCGAG -> CCTTTTTACACGACATGTCCGAGA
ACGAAGTCGTCATCCCGTCGTGAA -> CGAAGTCGTCATCCCGTCGTGAAC
ACGACACTGAACGCATGTAACGTA -> CGACACTGAACGCATGTAACGTAT
ACGACATGTCCGAGAACTATGTCG -> CGACATGTCCGAGAACTATGTCGT
ACGACGGGGATGAGTGCGACCCTT -> CGACGGGGATGAGTGCGACCCTTG
ACGAGCGGTGTGCGGGAGACTAAA -> CGAGCGGTGTGCGGGAGACTAAAA
ACGAGTCTGCGAGGTGTGCAGGGA -> CGAGTCTGCGAGGTGTGCAGGGAA
ACGAGTGTCTTAAACCCGTGTATT -> CGAGTGTCTTAAACCCGTGTATTG
ACGATGCACCAAGACTTGCCTCAC -> CGATGCACCAAGACTTGCCTCACA
ACGATGCGCCAACTTAACGCTTGA -> CGATGCGCCAACTTAACGCTTGAT
ACGATTAAGCTCCGCAAAAAGAGT -> CGATTAAGCTCCGCAAAAAGAGTG
ACGATTGCTAGCAACTATCTTCAT -> CGATTGCTAGCAACTATCTTCATT
ACGCACAGAACGGAGTCCACACGT -> CGCACAGAACGGAGTCCACACGTG
ACGCATGTAACGTATCCTTGGATA -> CGCATGTAACGTATCCTTGGATAC
ACGCCATTATTTTTAGGCCTCGTC -> CGCCATTATTTTTAGGCCTCGTCT
ACGCCGGAATTAGTGGCTGACGAG -> CGCCGGAATTAGTGGCTGACGAGT
ACGCCGGTTGTCCAGGAAGATTGT -> CGCCGGTTGTCCAGGAAGATTGTG
ACGCGGCAACGACGGGGATGAGTG -> CGCGGCAACGACGGGGATGAGTGC
ACGCGTCCGCAAATAGTAGGATAG -> CGCGTCCGCAAATAGTAGGATAGC
ACGCGTCTTACTGGATTGAGACTC -> CGCGTCTTACTGGATTGAGACTCG
ACGCTATTTGTTCAACAAGAAGTG -> CGCTATTTGTTCAACAAGAAGTGA
ACGCTCTGCGGGGGACATTGGACA -> CGCTCTGCGGGGGACATTGGACAC
ACGCTTGATATCTCTAGGTTACGC -> CGCTTGATATCTCTAGGTTACGCG
ACGCTTGTATAGACCGGCCGCACG -> CGCTTGTATAGACCGGCCGCACGT
ACGGACCCAATACAATCCGGCTTA -> CGGACCCAATACAATCCGGCTTAT
ACGGAGCTAGCGTTCTGCCGACTA -> CGGAGCTAGCGTTCTGCCGACTAA
ACGGAGTCCACACGTGCCCAATCG -> CGGAGTCCACACGTGCCCAATCGC
ACGGATCCATGCTGTCTTGATTAT -> CGGATCCATGCTGTCTTGATTATC
ACGGCAGGCTCTTCCAATACGGAG -> CGGCAGGCTCTTCCAATACGGAGC
ACGGCCTCTGTGGGGCATGTGCTG -> CGGCCTCTGTGGGGCATGTGCTGA
ACGGGGATGAGTGCGACCCTTGTA -> CGGGGATGAGTGCGACCCTTGTAA
ACGGTTACCTTGCCCCCCGGAGGT -> CGGTTACCTTGCCCCCCGGAGGTC
ACGTACCTTATTAAAATCCCTTAA -> CGTACCTTATTAAAATCCCTTAAT
ACGTATCCTTGGATACCCATGATA -> CGTATCCTTGGATACCCATGATAC
ACGTCAATATCATTTTAACTCGCT -> CGTCAATATCATTTTAACTCGCTG
ACGTCACCGGTGCTTGACGGTTAC -> CGTCACCGGTGCTTGACGGTTACC
ACGTCACGGACCCAATACAATCCG -> CGTCACGGACCCAATACAATCCGG
ACGTCGTGGAAGTTCTAAATCATA -> CGTCGTGGAAGTTCTAAATCATAT
ACGTGACCCCAGGGACCTTACGGC -> CGTGACCCCAGGGACCTTACGGCA
ACGTGCCCAATCGCGATACACCCA -> CGTGCCCAATCGCGATACACCCAG
ACTAAAAGAAGTCGAGGCCTTCGA -> CTAAAAGAAGTCGAGGCCTTCGAT
ACTAACCACCGGACAAAGGTATGA -> CTAACCACCGGACAAAGGTATGAG
ACTAACGCGTCCGCAAATAGTAGG -> CTAACGCGTCCGCAAATAGTAGGA
ACTAATAACTTGTACAAAACTTAC -> CTAATAACTTGTACAAAACTTACG
ACTAATGACCCTCGGGTTCCCCAG -> CTAATGACCCTCGGGTTCCCCAGG
ACTACTCTCTTAACTAATGACCCT -> CTACTCTCTTAACTAATGACCCTC
ACTAGGACGCCGGAATTAGTGGCT -> CTAGGACGCCGGAATTAGTGGCTG
ACTAGTCGTATCAAGTCAACACCA -> CTAGTCGTATCAAGTCAACACCAT
ACTATAACTTAGCAGCACACTGAG -> CTATAACTTAGCAGCACACTGAGG
ACTATCCCGTGGTGTGTATAAGAC -> CTATCCCGTGGTGTGTATAAGACA
ACTATCGCAAAACCCCTGACCTAA -> CTATCGCAAAACCCCTGACCTAAG
ACTATCTGATCCGAGCTGGTAGGT -> CTATCTGATCCGAGCTGGTAGGTA
ACTATCTTCATTACCAGTAGTCTA -> CTATCTTCATTACCAGTAGTCTAG
ACTATGTCGTGTCCAGCTCAGAGT -> CTATGTCGTGTCCAGCTCAGAGTA
ACTCACTAGTCGTATCAAGTCAAC -> CTCACTAGTCGTATCAAGTCAACA
ACTCATCGCTCGATAACCGGGGAA -> CTCATCGCTCGATAACCGGGGAAC
ACTCCATAAAAACCACACCCCGCA -> CTCCATAAAAACCACACCCCGCAA
ACTCCTTCATGGTTGCTTTCGTGT -> CTCCTTCATGGTTGCTTTCGTGTG
ACTCGACAAGCTCTTGGAGAACCT -> CTCGACAAGCTCTTGGAGAACCTC
ACTCGAGGCCCTTCGCTAGCTAAG -> CTCGAGGCCCTTCGCTAGCTAAGT
ACTCGCTGCAGCAGTTCTTACCGT -> CTCGCTGCAGCAGTTCTTACCGTT
ACTCTCATAGAAAAACAGGCTCAT -> CTCTCATAGAAAAACAGGCTCATA
ACTCTCTTAACTAATGACCCTCGG -> CTCTCTTAACTAATGACCCTCGGG
ACTCTGACACTTAAAACGCCGGTT -> CTCTGACACTTAAAACGCCGGTTG
ACTGAACGCATGTAACGTATCCTT -> CTGAACGCATGTAACGTATCCTTG
ACTGAGGTTAGTGTCCGCAGAACC -> CTGAGGTTAGTGTCCGCAGAACCG
ACTGGACCACGTCACCGGTGCTTG -> CTGGACCACGTCACCGGTGCTTGA
ACTGGACCTTCTATCGGCTGAACT -> CTGGACCTTCTATCGGCTGAACTT
ACTGGATTGAGACTCGACAAGCTC -> CTGGATTGAGACTCGACAAGCTCT
ACTGGCCTTAACATGACGTCGTGG -> CTGGCCTTAACATGACGTCGTGGA
ACTGGTCAGCGGATCGATTAATCT -> CTGGTCAGCGGATCGATTAATCTC
ACTGTCCCCGCTATCTAGTGTTTT -> CTGTCCCCGCTATCTAGTGTTTTT
ACTGTGCCTCCGAGCTGCGGACGA -> CTGTGCCTCCGAGCTGCGGACGAT
ACTTAAAACGCCGGTTGTCCAGGA -> CTTAAAACGCCGGTTGTCCAGGAA
ACTTAACGCTTGATATCTCTAGGT -> CTTAACGCTTGATATCTCTAGGTT
ACTTACGCACAGAACGGAGTCCAC -> CTTACGCACAGAACGGAGTCCACA
ACTTAGCAGCACACTGAGGTTAGT -> CTTAGCAGCACACTGAGGTTAGTG
ACTTGCCTCACAATCCGTGTGAAC -> CTTGCCTCACAATCCGTGTGAACA
ACTTGTACAAAACTTACGCACAGA -> CTTGTACAAAACTTACGCACAGAA
ACTTGTGTAAGTCTACTATCTGAT -> CTTGTGTAAGTCTACTATCTGATC
ACTTTACGCTCTGCGGGGGACATT -> CTTTACGCTCTGCGGGGGACATTG
AGAAAAACAGGCTCATATGCCCAA -> GAAAAACAGGCTCATATGCCCAAC
AGAAAATTAAAACATCTTGTCCTG -> GAAAATTAAAACATCTTGTCCTGT
AGAAAGCTCTCTAAACCACGCTAT -> GAAAGCTCTCTAAACCACGCTATT
AGAACCACGCTTGTATAGACCGGC -> GAACCACGCTTGTATAGACCGGCC
AGAACCGTCTTTAGCCTAGTTAGG -> GAACCGTCTTTAGCCTAGTTAGGC
AGAACCTCACTAACGCGTCCGCAA -> GAACCTCACTAACGCGTCCGCAAA
AGAACGGAGTCCACACGTGCCCAA -> GAACGGAGTCCACACGTGCCCAAT
AGAACTATGTCGTGTCCAGCTCAG -> GAACTATGTCGTGTCCAGCTCAGA
AGAAGCTGGCTCAGAATCTGCTAC -> GAAGCTGGCTCAGAATCTGCTACA
AGAAGTCGAGGCCTTCGATAAAAT -> GAAGTCGAGGCCTTCGATAAAATA
AGAAGTCTCACGTGACCCCAGGGA -> GAAGTCTCACGTGACCCCAGGGAC
AGAAGTGAAGCAGGTTCCATAAAC -> GAAGTGAAGCAGGTTCCATAAACA
AGAATCTGCTACATCCCCCGCATA -> GAATCTGCTACATCCCCCGCATAT
AGACAGCTATCCTGACATTGATTG -> GACAGCTATCCTGACATTGATTGG
AGACCGGCCGCACGTCACGGACCC -> GACCGGCCGCACGTCACGGACCCA
AGACTAAAAGAAGTCGAGGCCTTC -> GACTAAAAGAAGTCGAGGCCTTCG
AGACTATAACTTAGCAGCACACTG -> GACTATAACTTAGCAGCACACTGA
AGACTATCCCGTGGTGTGTATAAG -> GACTATCCCGTGGTGTGTATAAGA
AGACTCGACAAGCTCTTGGAGAAC -> GACTCGACAAGCTCTTGGAGAACC
AGACTGGACCTTCTATCGGCTGAA -> GACTGGACCTTCTATCGGCTGAAC
AGACTTGCCTCACAATCCGTGTGA -> GACTTGCCTCACAATCCGTGTGAA
AGAGTACACCAAGCGCACGAAGTC -> GAGTACACCAAGCGCACGAAGTCG
AGAGTGTATCATCGAACAGTCACA -> GAGTGTATCATCGAACAGTCACAT
AGATACACCTTTGCTGCCGACTAC -> GATACACCTTTGCTGCCGACTACT
AGATACCACGTACCTTATTAAAAT -> GATACCACGTACCTTATTAAAATC
AGATACGAGTCTGCGAGGTGTGCA -> GATACGAGTCTGCGAGGTGTGCAG
AGATATAAACTCCATAAAAACCAC -> GATATAAACTCCATAAAAACCACA
AGATGACTCGAGGCCCTTCGCTAG -> GATGACTCGAGGCCCTTCGCTAGC
AGATTGTGGAAGTAAAGAAAGCTC -> GATTGTGGAAGTAAAGAAAGCTCT
AGCAACTATCTTCATTACCAGTAG -> GCAACTATCTTCATTACCAGTAGT
AGCACACTGAGGTTAGTGTCCGCA -> GCACACTGAGGTTAGTGTCCGCAG
AGCACGGCCTCTGTGGGGCATGTG -> GCACGGCCTCTGTGGGGCATGTGC
AGCAGCACACTGAGGTTAGTGTCC -> GCAGCACACTGAGGTTAGTGTCCG
AGCAGGTTCCATAAACATCATTCT -> GCAGGTTCCATAAACATCATTCTT
AGCAGTTCTTACCGTTAGGATCAC -> GCAGTTCTTACCGTTAGGATCACT
AGCATCACGACACTGAACGCATGT -> GCATCACGACACTGAACGCATGTA
AGCCTAGTTAGGCAACATTGGAGT -> GCCTAGTTAGGCAACATTGGAGTT
AGCGCACGAAGTCGTCATCCCGTC -> GCGCACGAAGTCGTCATCCCGTCG
AGCGGATCGATTAATCTCGCGGAG -> GCGGATCGATTAATCTCGCGGAGG
AGCGGTGTGCGGGAGACTAAAAGA -> GCGGTGTGCGGGAGACTAAAAGAA
AGCGTTCCTGGTGGTGGTCTTTTG -> GCGTTCCTGGTGGTGGTCTTTTGT
AGCGTTCTGCCGACTAATAACTTG -> GCGTTCTGCCGACTAATAACTTGT
AGCTAAGTTGAATCTAGTCTTTCT -> GCTAAGTTGAATCTAGTCTTTCTT
AGCTACACACATGACCATTGACTC -> GCTACACACATGACCATTGACTCA
AGCTAGCGTTCTGCCGACTAATAA -> GCTAGCGTTCTGCCGACTAATAAC
AGCTATCCTGACATTGATTGGCAA -> GCTATCCTGACATTGATTGGCAAG
AGCTCAGAGTACACCAAGCGCACG -> GCTCAGAGTACACCAAGCGCACGA
AGCTCCGCAAAAAGAGTGTATCAT -> GCTCCGCAAAAAGAGTGTATCATC
AGCTCTCTAAACCACGCTATTTGT -> GCTCTCTAAACCACGCTATTTGTT
AGCTCTTGGAGAACCTCACTAACG -> GCTCTTGGAGAACCTCACTAACGC
AGCTGCGGACGATTAAGCTCCGCA -> GCTGCGGACGATTAAGCTCCGCAA
AGCTGGCTCAGAATCTGCTACATC -> GCTGGCTCAGAATCTGCTACATCC
AGCTGGTAGGTAGATACACCTTTG -> GCTGGTAGGTAGATACACCTTTGC
AGCTTATGTTGCCGCGAAGTGGGG -> GCTTATGTTGCCGCGAAGTGGGGT
AGCTTATTTCTTCTGGAACGCCAT -> GCTTATTTCTTCTGGAACGCCATT
AGCTTTTTCCGGTGGATCATTGAT -> GCTTTTTCCGGTGGATCATTGATG
AGGAAGATTGTGGAAGTAAAGAAA -> GGAAGATTGTGGAAGTAAAGAAAG
AGGACGCCGGAATTAGTGGCTGAC -> GGACGCCGGAATTAGTGGCTGACG
AGGACTAGGACGCCGGAATTAGTG -> GGACTAGGACGCCGGAATTAGTGG
AGGATAGCTTATGTTGCCGCGAAG -> GGATAGCTTATGTTGCCGCGAAGT
AGGATATCATTGGGACTCACTAGT -> GGATATCATTGGGACTCACTAGTC
AGGATCACTTGTGTAAGTCTACTA -> GGATCACTTGTGTAAGTCTACTAT
AGGCAAACTGGCCTTAACATGACG -> GGCAAACTGGCCTTAACATGACGT
AGGCAACATTGGAGTTGCTCGCTT -> GGCAACATTGGAGTTGCTCGCTTA
AGGCCAACGTCAATATCATTTTAA -> GGCCAACGTCAATATCATTTTAAC
AGGCCCCAGACTATAACTTAGCAG -> GGCCCCAGACTATAACTTAGCAGC
AGGCCCTTCGCTAGCTAAGTTGAA -> GGCCCTTCGCTAGCTAAGTTGAAT
AGGCCCTTCGTAGAACCACGCTTG -> GGCCCTTCGTAGAACCACGCTTGT
AGGCCTCGTCTGCACCATGTCTTT -> GGCCTCGTCTGCACCATGTCTTTA
AGGCCTTCGATAAAATATCAACTG -> GGCCTTCGATAAAATATCAACTGG
AGGCGAGATACCACGTACCTTATT -> GGCGAGATACCACGTACCTTATTA
AGGCTCATATGCCCAACTGGTCAG -> GGCTCATATGCCCAACTGGTCAGC
AGGCTCTTCCAATACGGAGCTAGC -> GGCTCTTCCAATACGGAGCTAGCG
AGGGAAAGAAGTCTCACGTGACCC -> GGGAAAGAAGTCTCACGTGACCCC
AGGGACCTTACGGCAGGCTCTTCC -> GGGACCTTACGGCAGGCTCTTCCA
AGGGAGTAGGGTCTGCGGTGGATA -> GGGAGTAGGGTCTGCGGTGGATAG
AGGGCCACACAGTCTATCCGACAC -> GGGCCACACAGTCTATCCGACACC
AGGGTCTGCGGTGGATAGGATATC -> GGGTCTGCGGTGGATAGGATATCA
AGGTAGATACACCTTTGCTGCCGA -> GGTAGATACACCTTTGCTGCCGAC
AGGTATGAGCGTTCCTGGTGGTGG -> GGTATGAGCGTTCCTGGTGGTGGT
AGGTCGATCGGAGTGGAGGGAGTA -> GGTCGATCGGAGTGGAGGGAGTAG
AGGTGACTCCTTCATGGTTGCTTT -> GGTGACTCCTTCATGGTTGCTTTC
AGGTGCAAAGCTTATTTCTTCTGG -> GGTGCAAAGCTTATTTCTTCTGGA
AGGTGTGCAGGGAAAGAAGTCTCA -> GGTGTGCAGGGAAAGAAGTCTCAC
AGGTTACGCGGCAACGACGGGGAT -> GGTTACGCGGCAACGACGGGGATG
AGGTTAGTGTCCGCAGAACCGTCT -> GGTTAGTGTCCGCAGAACCGTCTT
AGGTTATCACGATGCACCAAGACT -> GGTTATCACGATGCACCAAGACTT
AGGTTCCATAAACATCATTCTTAT -> GGTTCCATAAACATCATTCTTATT
AGTAAAATCTCCTGGGAGCATCAC -> GTAAAATCTCCTGGGAGCATCACG
AGTAAAGAAAGCTCTCTAAACCAC -> GTAAAGAAAGCTCTCTAAACCACG
AGTAATAGACTATCCCGTGGTGTG -> GTAATAGACTATCCCGTGGTGTGT
AGTACACCAAGCGCACGAAGTCGT -> GTACACCAAGCGCACGAAGTCGTC
AGTAGGATAGCTTATGTTGCCGCG -> GTAGGATAGCTTATGTTGCCGCGA
AGTAGGGTCTGCGGTGGATAGGAT -> GTAGGGTCTGCGGTGGATAGGATA
AGTAGTCTAGTAATAGACTATCCC -> GTAGTCTAGTAATAGACTATCCCG
AGTCAACACCATCGGGGTAGCTAC -> GTCAACACCATCGGGGTAGCTACA
AGTCACATGCGATATTCCCGCCGT -> GTCACATGCGATATTCCCGCCGTC
AGTCCACACGTGCCCAATCGCGAT -> GTCCACACGTGCCCAATCGCGATA
AGTCCGATCCGAATCTATTGTACC -> GTCCGATCCGAATCTATTGTACCT
AGTCGAGGCCTTCGATAAAATATC -> GTCGAGGCCTTCGATAAAATATCA
AGTCGTATCAAGTCAACACCATCG -> GTCGTATCAAGTCAACACCATCGG
AGTCGTCATCCCGTCGTGAACTAT -> GTCGTCATCCCGTCGTGAACTATC
AGTCTACTATCTGATCCGAGCTGG -> GTCTACTATCTGATCCGAGCTGGT
AGTCTAGTAATAGACTATCCCGTG -> GTCTAGTAATAGACTATCCCGTGG
AGTCTATCCGACACCATACAAAGA -> GTCTATCCGACACCATACAAAGAT
AGTCTCACGTGACCCCAGGGACCT -> GTCTCACGTGACCCCAGGGACCTT
AGTCTGCGAGGTGTGCAGGGAAAG -> GTCTGCGAGGTGTGCAGGGAAAGA
AGTCTTTCTTCAGTTCGTAACCTT -> GTCTTTCTTCAGTTCGTAACCTTC
AGTGAAGCAGGTTCCATAAACATC -> GTGAAGCAGGTTCCATAAACATCA
AGTGCGACCCTTGTAATATCCGGT -> GTGCGACCCTTGTAATATCCGGTG
AGTGGACGGATCCATGCTGTCTTG -> GTGGACGGATCCATGCTGTCTTGA
AGTGGAGGGAGTAGGGTCTGCGGT -> GTGGAGGGAGTAGGGTCTGCGGTG
AGTGGCTGACGAGTGTCTTAAACC -> GTGGCTGACGAGTGTCTTAAACCC
AGTGGGGTAGGCCAACGTCAATAT -> GTGGGGTAGGCCAACGTCAATATC
AGTGTATCATCGAACAGTCACATG -> GTGTATCATCGAACAGTCACATGC
AGTGTCCGCAGAACCGTCTTTAGC -> GTGTCCGCAGAACCGTCTTTAGCC
AGTGTCTTAAACCCGTGTATTGAC -> GTGTCTTAAACCCGTGTATTGACA
AGTGTTTTTGATATTTGCATAGCT -> GTGTTTTTGATATTTGCATAGCTT
AGTTAGGCAACATTGGAGTTGCTC -> GTTAGGCAACATTGGAGTTGCTCG
AGTTCGTAACCTTCATAGGACTAG -> GTTCGTAACCTTCATAGGACTAGG
AGTTCTAAATCATATCACTAACCA -> GTTCTAAATCATATCACTAACCAC
AGTTCTTACCGTTAGGATCACTTG -> GTTCTTACCGTTAGGATCACTTGT
AGTTGAATCTAGTCTTTCTTCAGT -> GTTGAATCTAGTCTTTCTTCAGTT
AGTTGCTCGCTTATTCGAATAAGT -> GTTGCTCGCTTATTCGAATAAGTG
ATAAAAACCACACCCCGCAATTCT -> TAAAAACCACACCCCGCAATTCTA
ATAAAATATCAACTGGACCACGTC -> TAAAATATCAACTGGACCACGTCA
ATAAACATCATTCTTATTTCAGGC -> TAAACATCATTCTTATTTCAGGCC
ATAAACTCCATAAAAACCACACCC -> TAAACTCCATAAAAACCACACCCC
ATAACCGGGGAACAAGGTGACTCC -> TAACCGGGGAACAAGGTGACTCCT
ATAACTTAGCAGCACACTGAGGTT -> TAACTTAGCAGCACACTGAGGTTA
ATAACTTGTACAAAACTTACGCAC -> TAACTTGTACAAAACTTACGCACA
ATAAGACAGCTATCCTGACATTGA -> TAAGACAGCTATCCTGACATTGAT
ATAAGTGGACGGATCCATGCTGTC -> TAAGTGGACGGATCCATGCTGTCT
ATACAAAGATATAAACTCCATAAA -> TACAAAGATATAAACTCCATAAAA
ATACAATCCGGCTTATGACCATCA -> TACAATCCGGCTTATGACCATCAC
ATACACCCAGGTTATCACGATGCA -> TACACCCAGGTTATCACGATGCAC
ATACACCTTTGCTGCCGACTACTC -> TACACCTTTGCTGCCGACTACTCT
ATACACGCGTCTTACTGGATTGAG -> TACACGCGTCTTACTGGATTGAGA
ATACCACGTACCTTATTAAAATCC -> TACCACGTACCTTATTAAAATCCC
ATACCCATGATACACGCGTCTTAC -> TACCCATGATACACGCGTCTTACT
ATACGAGTCTGCGAGGTGTGCAGG -> TACGAGTCTGCGAGGTGTGCAGGG
ATACGGAGCTAGCGTTCTGCCGAC -> TACGGAGCTAGCGTTCTGCCGACT
ATAGAAAAACAGGCTCATATGCCC -> TAGAAAAACAGGCTCATATGCCCA
ATAGAAAATTAAAACATCTTGTCC -> TAGAAAATTAAAACATCTTGTCCT
ATAGACCGGCCGCACGTCACGGAC -> TAGACCGGCCGCACGTCACGGACC
ATAGACTATCCCGTGGTGTGTATA -> TAGACTATCCCGTGGTGTGTATAA
ATAGCTTATGTTGCCGCGAAGTGG -> TAGCTTATGTTGCCGCGAAGTGGG
ATAGCTTTTTCCGGTGGATCATTG -> TAGCTTTTTCCGGTGGATCATTGA
ATAGGACTAGGACGCCGGAATTAG -> TAGGACTAGGACGCCGGAATTAGT
ATAGGATATCATTGGGACTCACTA -> TAGGATATCATTGGGACTCACTAG
ATAGTAGGATAGCTTATGTTGCCG -> TAGTAGGATAGCTTATGTTGCCGC
ATATAAACTCCATAAAAACCACAC -> TATAAACTCCATAAAAACCACACC
ATATCAACTGGACCACGTCACCGG -> TATCAACTGGACCACGTCACCGGT
ATATCACTAACCACCGGACAAAGG -> TATCACTAACCACCGGACAAAGGT
ATATCATTGGGACTCACTAGTCGT -> TATCATTGGGACTCACTAGTCGTA
ATATCATTTTAACTCGCTGCAGCA -> TATCATTTTAACTCGCTGCAGCAG
ATATCCGGTGTCCGACTGTGCCTC -> TATCCGGTGTCCGACTGTGCCTCC
ATATCTCTAGGTTACGCGGCAACG -> TATCTCTAGGTTACGCGGCAACGA
ATATGCCCAACTGGTCAGCGGATC -> TATGCCCAACTGGTCAGCGGATCG
ATATTACCTCTCGAGGCGAGATAC -> TATTACCTCTCGAGGCGAGATACC
ATATTCCCGCCGTCCTTGATTCAC -> TATTCCCGCCGTCCTTGATTCACC
ATATTTGCATAGCTTTTTCCGGTG -> TATTTGCATAGCTTTTTCCGGTGG
ATCAACTGGACCACGTCACCGGTG -> TCAACTGGACCACGTCACCGGTGC
ATCAAGTCAACACCATCGGGGTAG -> TCAAGTCAACACCATCGGGGTAGC
ATCACCTACATTTATCCCAGTCCG -> TCACCTACATTTATCCCAGTCCGA
ATCACGACACTGAACGCATGTAAC -> TCACGACACTGAACGCATGTAACG
ATCACGATGCACCAAGACTTGCCT -> TCACGATGCACCAAGACTTGCCTC
ATCACTAACCACCGGACAAAGGTA -> TCACTAACCACCGGACAAAGGTAT
ATCACTCCAAGCCCCCGCATTTCG -> TCACTCCAAGCCCCCGCATTTCGG
ATCACTTGTGTAAGTCTACTATCT -> TCACTTGTGTAAGTCTACTATCTG
ATCATATCACTAACCACCGGACAA -> TCATATCACTAACCACCGGACAAA
ATCATCGAACAGTCACATGCGATA -> TCATCGAACAGTCACATGCGATAT
ATCATTCTTATTTCAGGCCCCAGA -> TCATTCTTATTTCAGGCCCCAGAC
ATCATTGATGCCAGGCAAACTGGC -> TCATTGATGCCAGGCAAACTGGCC
ATCATTGGGACTCACTAGTCGTAT -> TCATTGGGACTCACTAGTCGTATC
ATCATTTTAACTCGCTGCAGCAGT -> TCATTTTAACTCGCTGCAGCAGTT
ATCCAGGGCCACACAGTCTATCCG -> TCCAGGGCCACACAGTCTATCCGA
ATCCATGCTGTCTTGATTATCCAG -> TCCATGCTGTCTTGATTATCCAGG
ATCCCAGTCCGATCCGAATCTATT -> TCCCAGTCCGATCCGAATCTATTG
ATCCCCCGCATATTACCTCTCGAG -> TCCCCCGCATATTACCTCTCGAGG
ATCCCGTCGTGAACTATCGCAAAA -> TCCCGTCGTGAACTATCGCAAAAC
ATCCCGTGGTGTGTATAAGACAGC -> TCCCGTGGTGTGTATAAGACAGCT
ATCCCTTAATAGAAAATTAAAACA -> TCCCTTAATAGAAAATTAAAACAT
ATCCGAATCTATTGTACCTTTTTA -> TCCGAATCTATTGTACCTTTTTAC
ATCCGACACCATACAAAGATATAA -> TCCGACACCATACAAAGATATAAA
ATCCGAGCTGGTAGGTAGATACAC -> TCCGAGCTGGTAGGTAGATACACC
ATCCGGCTTATGACCATCACTCCA -> TCCGGCTTATGACCATCACTCCAA
ATCCGGTGTCCGACTGTGCCTCCG -> TCCGGTGTCCGACTGTGCCTCCGA
ATCCGTGTGAACAGATGACTCGAG -> TCCGTGTGAACAGATGACTCGAGG
ATCCTGACATTGATTGGCAAGTAA -> TCCTGACATTGATTGGCAAGTAAA
ATCCTTGGATACCCATGATACACG -> TCCTTGGATACCCATGATACACGC
ATCGAACAGTCACATGCGATATTC -> TCGAACAGTCACATGCGATATTCC
ATCGATTAATCTCGCGGAGGTGCA -> TCGATTAATCTCGCGGAGGTGCAA
ATCGCAAAACCCCTGACCTAAGAC -> TCGCAAAACCCCTGACCTAAGACT
ATCGCGATACACCCAGGTTATCAC -> TCGCGATACACCCAGGTTATCACG
ATCGCTCGATAACCGGGGAACAAG -> TCGCTCGATAACCGGGGAACAAGG
ATCGGAGTGGAGGGAGTAGGGTCT -> TCGGAGTGGAGGGAGTAGGGTCTG
ATCGGCTGAACTTTACGCTCTGCG -> TCGGCTGAACTTTACGCTCTGCGG
ATCGGGGTAGCTACACACATGACC -> TCGGGGTAGCTACACACATGACCA
ATCGGGTTGGTACGATTGCTAGCA -> TCGGGTTGGTACGATTGCTAGCAA
ATCTAGTCTTTCTTCAGTTCGTAA -> TCTAGTCTTTCTTCAGTTCGTAAC
ATCTAGTGTTTTTGATATTTGCAT -> TCTAGTGTTTTTGATATTTGCATA
ATCTATTGTACCTTTTTACACGAC -> TCTATTGTACCTTTTTACACGACA
ATCTCCCTTGGACAACATCGGGTT -> TCTCCCTTGGACAACATCGGGTTG
ATCTCCTGGGAGCATCACGACACT -> TCTCCTGGGAGCATCACGACACTG
ATCTCGCGGAGGTGCAAAGCTTAT -> TCTCGCGGAGGTGCAAAGCTTATT
ATCTCTAGGTTACGCGGCAACGAC -> TCTCTAGGTTACGCGGCAACGACG
ATCTGATCCGAGCTGGTAGGTAGA -> TCTGATCCGAGCTGGTAGGTAGAT
ATCTGCTACATCCCCCGCATATTA -> TCTGCTACATCCCCCGCATATTAC
ATCTTCATTACCAGTAGTCTAGTA -> TCTTCATTACCAGTAGTCTAGTAA
ATCTTGTCCTGTTAAATTCCAGCA -> TCTTGTCCTGTTAAATTCCAGCAC
ATGACCATCACTCCAAGCCCCCGC -> TGACCATCACTCCAAGCCCCCGCA
ATGACCATTGACTCATCGCTCGAT -> TGACCATTGACTCATCGCTCGATA
ATGACCCTCGGGTTCCCCAGGCCC -> TGACCCTCGGGTTCCCCAGGCCCT
ATGACGTCGTGGAAGTTCTAAATC -> TGACGTCGTGGAAGTTCTAAATCA
ATGACTCGAGGCCCTTCGCTAGCT -> TGACTCGAGGCCCTTCGCTAGCTA
ATGAGCGTTCCTGGTGGTGGTCTT -> TGAGCGTTCCTGGTGGTGGTCTTT
ATGAGTGCGACCCTTGTAATATCC -> TGAGTGCGACCCTTGTAATATCCG
ATGATACACGCGTCTTACTGGATT -> TGATACACGCGTCTTACTGGATTG
ATGCACCAAGACTTGCCTCACAAT -> TGCACCAAGACTTGCCTCACAATC
ATGCCAGGCAAACTGGCCTTAACA -> TGCCAGGCAAACTGGCCTTAACAT
ATGCCCAACTGGTCAGCGGATCGA -> TGCCCAACTGGTCAGCGGATCGAT
ATGCGATATTCCCGCCGTCCTTGA -> TGCGATATTCCCGCCGTCCTTGAT
ATGCGCCAACTTAACGCTTGATAT -> TGCGCCAACTTAACGCTTGATATC
ATGCTGTCTTGATTATCCAGGGCC -> TGCTGTCTTGATTATCCAGGGCCA
ATGGTTGCTTTCGTGTGGTATTCT -> TGGTTGCTTTCGTGTGGTATTCTC
ATGTAACGTATCCTTGGATACCCA -> TGTAACGTATCCTTGGATACCCAT
ATGTCCGAGAACTATGTCGTGTCC -> TGTCCGAGAACTATGTCGTGTCCA
ATGTCGTGTCCAGCTCAGAGTACA -> TGTCGTGTCCAGCTCAGAGTACAC
ATGTCTTTACGATGCGCCAACTTA -> TGTCTTTACGATGCGCCAACTTAA
ATGTGCTGAGATACGAGTCTGCGA -> TGTGCTGAGATACGAGTCTGCGAG
ATGTTGCCGCGAAGTGGGGTAGGC -> TGTTGCCGCGAAGTGGGGTAGGCC
ATTAAAACATCTTGTCCTGTTAAA -> TTAAAACATCTTGTCCTGTTAAAT
ATTAAAATCCCTTAATAGAAAATT -> TTAAAATCCCTTAATAGAAAATTA
ATTAAGCTCCGCAAAAAGAGTGTA -> TTAAGCTCCGCAAAAAGAGTGTAT
ATTAATCTCGCGGAGGTGCAAAGC -> TTAATCTCGCGGAGGTGCAAAGCT
ATTACCAGTAGTCTAGTAATAGAC -> TTACCAGTAGTCTAGTAATAGACT
ATTACCTCTCGAGGCGAGATACCA -> TTACCTCTCGAGGCGAGATACCAC
ATTAGTGGCTGACGAGTGTCTTAA -> TTAGTGGCTGACGAGTGTCTTAAA
ATTATCCAGGGCCACACAGTCTAT -> TTATCCAGGGCCACACAGTCTATC
ATTATTTTTAGGCCTCGTCTGCAC -> TTATTTTTAGGCCTCGTCTGCACC
ATTCACCATTGGGCACTGTCCCCG -> TTCACCATTGGGCACTGTCCCCGC
ATTCCAGCACGGCCTCTGTGGGGC -> TTCCAGCACGGCCTCTGTGGGGCA
ATTCCCGCCGTCCTTGATTCACCA -> TTCCCGCCGTCCTTGATTCACCAT
ATTCGAATAAGTGGACGGATCCAT -> TTCGAATAAGTGGACGGATCCATG
ATTCTACTCTCATAGAAAAACAGG -> TTCTACTCTCATAGAAAAACAGGC
ATTCTCCAGAAGCTGGCTCAGAAT -> TTCTCCAGAAGCTGGCTCAGAATC
ATTCTTATTTCAGGCCCCAGACTA -> TTCTTATTTCAGGCCCCAGACTAT
ATTGACACTCTGACACTTAAAACG -> TTGACACTCTGACACTTAAAACGC
ATTGACTCATCGCTCGATAACCGG -> TTGACTCATCGCTCGATAACCGGG
ATTGAGACTCGACAAGCTCTTGGA -> TTGAGACTCGACAAGCTCTTGGAG
ATTGATGCCAGGCAAACTGGCCTT -> TTGATGCCAGGCAAACTGGCCTTA
ATTGATTGGCAAGTAAAATCTCCT -> TTGATTGGCAAGTAAAATCTCCTG
ATTGCTAGCAACTATCTTCATTAC -> TTGCTAGCAACTATCTTCATTACC
ATTGGACACACGAGCGGTGTGCGG -> TTGGACACACGAGCGGTGTGCGGG
ATTGGAGTTGCTCGCTTATTCGAA -> TTGGAGTTGCTCGCTTATTCGAAT
ATTGGCAAGTAAAATCTCCTGGGA -> TTGGCAAGTAAAATCTCCTGGGAG
ATTGGGACTCACTAGTCGTATCAA -> TTGGGACTCACTAGTCGTATCAAG
ATTGGGCACTGTCCCCGCTATCTA -> TTGGGCACTGTCCCCGCTATCTAG
ATTGTACCTTTTTACACGACATGT -> TTGTACCTTTTTACACGACATGTC
ATTGTGGAAGTAAAGAAAGCTCTC -> TTGTGGAAGTAAAGAAAGCTCTCT
ATTTATCCCAGTCCGATCCGAATC -> TTTATCCCAGTCCGATCCGAATCT
ATTTCAGGCCCCAGACTATAACTT -> TTTCAGGCCCCAGACTATAACTTA
ATTTCTTCTGGAACGCCATTATTT -> TTTCTTCTGGAACGCCATTATTTT
ATTTGCATAGCTTTTTCCGGTGGA -> TTTGCATAGCTTTTTCCGGTGGAT
ATTTGTTCAACAAGAAGTGAAGCA -> TTTGTTCAACAAGAAGTGAAGCAG
ATTTTAACTCGCTGCAGCAGTTCT -> TTTTAACTCGCTGCAGCAGTTCTT
ATTTTTAGGCCTCGTCTGCACCAT -> TTTTTAGGCCTCGTCTGCACCATG
CAAAAAGAGTGTATCATCGAACAG -> AAAAAGAGTGTATCATCGAACAGT
CAAAACCCCTGACCTAAGACTGGA -> AAAACCCCTGACCTAAGACTGGAC
CAAAACTTACGCACAGAACGGAGT -> AAAACTTACGCACAGAACGGAGTC
CAAACTGGCCTTAACATGACGTCG -> AAACTGGCCTTAACATGACGTCGT
CAAAGATATAAACTCCATAAAAAC -> AAAGATATAAACTCCATAAAAACC
CAAAGCTTATTTCTTCTGGAACGC -> AAAGCTTATTTCTTCTGGAACGCC
CAAAGGTATGAGCGTTCCTGGTGG -> AAAGGTATGAGCGTTCCTGGTGGT
CAAATAGTAGGATAGCTTATGTTG -> AAATAGTAGGATAGCTTATGTTGC
CAACAAGAAGTGAAGCAGGTTCCA -> AACAAGAAGTGAAGCAGGTTCCAT
CAACACCATCGGGGTAGCTACACA -> AACACCATCGGGGTAGCTACACAC
CAACATCGGGTTGGTACGATTGCT -> AACATCGGGTTGGTACGATTGCTA
CAACATTGGAGTTGCTCGCTTATT -> AACATTGGAGTTGCTCGCTTATTC
CAACGACGGGGATGAGTGCGACCC -> AACGACGGGGATGAGTGCGACCCT
CAACGTCAATATCATTTTAACTCG -> AACGTCAATATCATTTTAACTCGC
CAACTATCTTCATTACCAGTAGTC -> AACTATCTTCATTACCAGTAGTCT
CAACTGGACCACGTCACCGGTGCT -> AACTGGACCACGTCACCGGTGCTT
CAACTGGTCAGCGGATCGATTAAT -> AACTGGTCAGCGGATCGATTAATC
CAACTTAACGCTTGATATCTCTAG -> AACTTAACGCTTGATATCTCTAGG
CAAGAAGTGAAGCAGGTTCCATAA -> AAGAAGTGAAGCAGGTTCCATAAA
CAAGACTTGCCTCACAATCCGTGT -> AAGACTTGCCTCACAATCCGTGTG
CAAGCGCACGAAGTCGTCATCCCG -> AAGCGCACGAAGTCGTCATCCCGT
CAAGCTCTTGGAGAACCTCACTAA -> AAGCTCTTGGAGAACCTCACTAAC
CAAGGTGACTCCTTCATGGTTGCT -> AAGGTGACTCCTTCATGGTTGCTT
CAAGTAAAATCTCCTGGGAGCATC -> AAGTAAAATCTCCTGGGAGCATCA
CAAGTCAACACCATCGGGGTAGCT -> AAGTCAACACCATCGGGGTAGCTA
CAATACAATCCGGCTTATGACCAT -> AATACAATCCGGCTTATGACCATC
CAATACGGAGCTAGCGTTCTGCCG -> AATACGGAGCTAGCGTTCTGCCGA
CAATATCATTTTAACTCGCTGCAG -> AATATCATTTTAACTCGCTGCAGC
CAATCCGGCTTATGACCATCACTC -> AATCCGGCTTATGACCATCACTCC
CAATCCGTGTGAACAGATGACTCG -> AATCCGTGTGAACAGATGACTCGA
CAATCGCGATACACCCAGGTTATC -> AATCGCGATACACCCAGGTTATCA
CAATTCTACTCTCATAGAAAAACA -> AATTCTACTCTCATAGAAAAACAG
CACAATCCGTGTGAACAGATGACT -> ACAATCCGTGTGAACAGATGACTC
CACACAGTCTATCCGACACCATAC -> ACACAGTCTATCCGACACCATACA
CACACATGACCATTGACTCATCGC -> ACACATGACCATTGACTCATCGCT
CACACCCCGCAATTCTACTCTCAT -> ACACCCCGCAATTCTACTCTCATA
CACACGAGCGGTGTGCGGGAGACT -> ACACGAGCGGTGTGCGGGAGACTA
CACACGTGCCCAATCGCGATACAC -> ACACGTGCCCAATCGCGATACACC
CACACTGAGGTTAGTGTCCGCAGA -> ACACTGAGGTTAGTGTCCGCAGAA
CACAGAACGGAGTCCACACGTGCC -> ACAGAACGGAGTCCACACGTGCCC
CACAGTCTATCCGACACCATACAA -> ACAGTCTATCCGACACCATACAAA
CACATGACCATTGACTCATCGCTC -> ACATGACCATTGACTCATCGCTCG
CACATGCGATATTCCCGCCGTCCT -> ACATGCGATATTCCCGCCGTCCTT
CACCAAGACTTGCCTCACAATCCG -> ACCAAGACTTGCCTCACAATCCGT
CACCAAGCGCACGAAGTCGTCATC -> ACCAAGCGCACGAAGTCGTCATCC
CACCATACAAAGATATAAACTCCA -> ACCATACAAAGATATAAACTCCAT
CACCATCGGGGTAGCTACACACAT -> ACCATCGGGGTAGCTACACACATG
CACCATGTCTTTACGATGCGCCAA -> ACCATGTCTTTACGATGCGCCAAC
CACCATTGGGCACTGTCCCCGCTA -> ACCATTGGGCACTGTCCCCGCTAT
CACCCAGGTTATCACGATGCACCA -> ACCCAGGTTATCACGATGCACCAA
CACCCCGCAATTCTACTCTCATAG -> ACCCCGCAATTCTACTCTCATAGA
CACCGGACAAAGGTATGAGCGTTC -> ACCGGACAAAGGTATGAGCGTTCC
CACCGGTGCTTGACGGTTACCTTG -> ACCGGTGCTTGACGGTTACCTTGC
CACCTACATTTATCCCAGTCCGAT -> ACCTACATTTATCCCAGTCCGATC
CACCTTTGCTGCCGACTACTCTCT -> ACCTTTGCTGCCGACTACTCTCTT
CACGAAGTCGTCATCCCGTCGTGA -> ACGAAGTCGTCATCCCGTCGTGAA
CACGACACTGAACGCATGTAACGT -> ACGACACTGAACGCATGTAACGTA
CACGACATGTCCGAGAACTATGTC -> ACGACATGTCCGAGAACTATGTCG
CACGAGCGGTGTGCGGGAGACTAA -> ACGAGCGGTGTGCGGGAGACTAAA
CACGATGCACCAAGACTTGCCTCA -> ACGATGCACCAAGACTTGCCTCAC
CACGCGTCTTACTGGATTGAGACT -> ACGCGTCTTACTGGATTGAGACTC
CACGCTATTTGTTCAACAAGAAGT -> ACGCTATTTGTTCAACAAGAAGTG
CACGCTTGTATAGACCGGCCGCAC -> ACGCTTGTATAGACCGGCCGCACG
CACGGACCCAATACAATCCGGCTT -> ACGGACCCAATACAATCCGGCTTA
CACGGCCTCTGTGGGGCATGTGCT -> ACGGCCTCTGTGGGGCATGTGCTG
CACGTACCTTATTAAAATCCCTTA -> ACGTACCTTATTAAAATCCCTTAA
CACGTCACCGGTGCTTGACGGTTA -> ACGTCACCGGTGCTTGACGGTTAC
CACGTCACGGACCCAATACAATCC -> ACGTCACGGACCCAATACAATCCG
CACGTGACCCCAGGGACCTTACGG -> ACGTGACCCCAGGGACCTTACGGC
CACGTGCCCAATCGCGATACACCC -> ACGTGCCCAATCGCGATACACCCA
CACTAACCACCGGACAAAGGTATG -> ACTAACCACCGGACAAAGGTATGA
CACTAACGCGTCCGCAAATAGTAG -> ACTAACGCGTCCGCAAATAGTAGG
CACTAGTCGTATCAAGTCAACACC -> ACTAGTCGTATCAAGTCAACACCA
CACTCTGACACTTAAAACGCCGGT -> ACTCTGACACTTAAAACGCCGGTT
CACTGAACGCATGTAACGTATCCT -> ACTGAACGCATGTAACGTATCCTT
CACTGAGGTTAGTGTCCGCAGAAC -> ACTGAGGTTAGTGTCCGCAGAACC
CACTGTCCCCGCTATCTAGTGTTT -> ACTGTCCCCGCTATCTAGTGTTTT
CACTTAAAACGCCGGTTGTCCAGG -> ACTTAAAACGCCGGTTGTCCAGGA
CACTTGTGTAAGTCTACTATCTGA -> ACTTGTGTAAGTCTACTATCTGAT
CAGAACCGTCTTTAGCCTAGTTAG -> AGAACCGTCTTTAGCCTAGTTAGG
CAGAACGGAGTCCACACGTGCCCA -> AGAACGGAGTCCACACGTGCCCAA
CAGAAGCTGGCTCAGAATCTGCTA -> AGAAGCTGGCTCAGAATCTGCTAC
CAGAATCTGCTACATCCCCCGCAT -> AGAATCTGCTACATCCCCCGCATA
CAGACTATAACTTAGCAGCACACT -> AGACTATAACTTAGCAGCACACTG
CAGAGTACACCAAGCGCACGAAGT -> AGAGTACACCAAGCGCACGAAGTC
CAGATGACTCGAGGCCCTTCGCTA -> AGATGACTCGAGGCCCTTCGCTAG
CAGCACACTGAGGTTAGTGTCCGC -> AGCACACTGAGGTTAGTGTCCGCA
CAGCACGGCCTCTGTGGGGCATGT -> AGCACGGCCTCTGTGGGGCATGTG
CAGCAGTTCTTACCGTTAGGATCA -> AGCAGTTCTTACCGTTAGGATCAC
CAGCGGATCGATTAATCTCGCGGA -> AGCGGATCGATTAATCTCGCGGAG
CAGCTATCCTGACATTGATTGGCA -> AGCTATCCTGACATTGATTGGCAA
CAGCTCAGAGTACACCAAGCGCAC -> AGCTCAGAGTACACCAAGCGCACG
CAGGAAGATTGTGGAAGTAAAGAA -> AGGAAGATTGTGGAAGTAAAGAAA
CAGGCAAACTGGCCTTAACATGAC -> AGGCAAACTGGCCTTAACATGACG
CAGGCCCCAGACTATAACTTAGCA -> AGGCCCCAGACTATAACTTAGCAG
CAGGCCCTTCGTAGAACCACGCTT -> AGGCCCTTCGTAGAACCACGCTTG
CAGGCTCATATGCCCAACTGGTCA -> AGGCTCATATGCCCAACTGGTCAG
CAGGCTCTTCCAATACGGAGCTAG -> AGGCTCTTCCAATACGGAGCTAGC
CAGGGAAAGAAGTCTCACGTGACC -> AGGGAAAGAAGTCTCACGTGACCC
CAGGGACCTTACGGCAGGCTCTTC -> AGGGACCTTACGGCAGGCTCTTCC
CAGGGCCACACAGTCTATCCGACA -> AGGGCCACACAGTCTATCCGACAC
CAGGTTATCACGATGCACCAAGAC -> AGGTTATCACGATGCACCAAGACT
CAGGTTCCATAAACATCATTCTTA -> AGGTTCCATAAACATCATTCTTAT
CAGTAGTCTAGTAATAGACTATCC -> AGTAGTCTAGTAATAGACTATCCC
CAGTCACATGCGATATTCCCGCCG -> AGTCACATGCGATATTCCCGCCGT
CAGTCCGATCCGAATCTATTGTAC -> AGTCCGATCCGAATCTATTGTACC
CAGTCTATCCGACACCATACAAAG -> AGTCTATCCGACACCATACAAAGA
CAGTTCGTAACCTTCATAGGACTA -> AGTTCGTAACCTTCATAGGACTAG
CAGTTCTTACCGTTAGGATCACTT -> AGTTCTTACCGTTAGGATCACTTG
CATAAAAACCACACCCCGCAATTC -> ATAAAAACCACACCCCGCAATTCT
CATAAACATCATTCTTATTTCAGG -> ATAAACATCATTCTTATTTCAGGC
CATACAAAGATATAAACTCCATAA -> ATACAAAGATATAAACTCCATAAA
CATAGAAAAACAGGCTCATATGCC -> ATAGAAAAACAGGCTCATATGCCC
CATAGCTTTTTCCGGTGGATCATT -> ATAGCTTTTTCCGGTGGATCATTG
CATAGGACTAGGACGCCGGAATTA -> ATAGGACTAGGACGCCGGAATTAG
CATATCACTAACCACCGGACAAAG -> ATATCACTAACCACCGGACAAAGG
CATATGCCCAACTGGTCAGCGGAT -> ATATGCCCAACTGGTCAGCGGATC
CATATTACCTCTCGAGGCGAGATA -> ATATTACCTCTCGAGGCGAGATAC
CATCACGACACTGAACGCATGTAA -> ATCACGACACTGAACGCATGTAAC
CATCACTCCAAGCCCCCGCATTTC -> ATCACTCCAAGCCCCCGCATTTCG
CATCATTCTTATTTCAGGCCCCAG -> ATCATTCTTATTTCAGGCCCCAGA
CATCCCCCGCATATTACCTCTCGA -> ATCCCCCGCATATTACCTCTCGAG
CATCCCGTCGTGAACTATCGCAAA -> ATCCCGTCGTGAACTATCGCAAAA
CATCGAACAGTCACATGCGATATT -> ATCGAACAGTCACATGCGATATTC
CATCGCTCGATAACCGGGGAACAA -> ATCGCTCGATAACCGGGGAACAAG
CATCGGGGTAGCTACACACATGAC -> ATCGGGGTAGCTACACACATGACC
CATCGGGTTGGTACGATTGCTAGC -> ATCGGGTTGGTACGATTGCTAGCA
CATCTCCCTTGGACAACATCGGGT -> ATCTCCCTTGGACAACATCGGGTT
CATCTTGTCCTGTTAAATTCCAGC -> ATCTTGTCCTGTTAAATTCCAGCA
CATGACCATTGACTCATCGCTCGA -> ATGACCATTGACTCATCGCTCGAT
CATGACGTCGTGGAAGTTCTAAAT -> ATGACGTCGTGGAAGTTCTAAATC
CATGATACACGCGTCTTACTGGAT -> ATGATACACGCGTCTTACTGGATT
CATGCGATATTCCCGCCGTCCTTG -> ATGCGATATTCCCGCCGTCCTTGA
CATGCTGTCTTGATTATCCAGGGC -> ATGCTGTCTTGATTATCCAGGGCC
CATGGTTGCTTTCGTGTGGTATTC -> ATGGTTGCTTTCGTGTGGTATTCT
CATGTAACGTATCCTTGGATACCC -> ATGTAACGTATCCTTGGATACCCA
CATGTCCGAGAACTATGTCGTGTC -> ATGTCCGAGAACTATGTCGTGTCC
CATGTCTTTACGATGCGCCAACTT -> ATGTCTTTACGATGCGCCAACTTA
CATGTGCTGAGATACGAGTCTGCG -> ATGTGCTGAGATACGAGTCTGCGA
CATTACCAGTAGTCTAGTAATAGA -> ATTACCAGTAGTCTAGTAATAGAC
CATTATTTTTAGGCCTCGTCTGCA -> ATTATTTTTAGGCCTCGTCTGCAC
CATTCTTATTTCAGGCCCCAGACT -> ATTCTTATTTCAGGCCCCAGACTA
CATTGACTCATCGCTCGATAACCG -> ATTGACTCATCGCTCGATAACCGG
CATTGATGCCAGGCAAACTGGCCT -> ATTGATGCCAGGCAAACTGGCCTT
CATTGATTGGCAAGTAAAATCTCC -> ATTGATTGGCAAGTAAAATCTCCT
CATTGGACACACGAGCGGTGTGCG -> ATTGGACACACGAGCGGTGTGCGG
CATTGGAGTTGCTCGCTTATTCGA -> ATTGGAGTTGCTCGCTTATTCGAA
CATTGGGACTCACTAGTCGTATCA -> ATTGGGACTCACTAGTCGTATCAA
CATTGGGCACTGTCCCCGCTATCT -> ATTGGGCACTGTCCCCGCTATCTA
CATTTATCCCAGTCCGATCCGAAT -> ATTTATCCCAGTCCGATCCGAATC
CATTTTAACTCGCTGCAGCAGTTC -> ATTTTAACTCGCTGCAGCAGTTCT
CCAACGTCAATATCATTTTAACTC -> CAACGTCAATATCATTTTAACTCG
CCAACTGGTCAGCGGATCGATTAA -> CAACTGGTCAGCGGATCGATTAAT
CCAACTTAACGCTTGATATCTCTA -> CAACTTAACGCTTGATATCTCTAG
CCAAGACTTGCCTCACAATCCGTG -> CAAGACTTGCCTCACAATCCGTGT
CCAAGCGCACGAAGTCGTCATCCC -> CAAGCGCACGAAGTCGTCATCCCG
CCAATACAATCCGGCTTATGACCA -> CAATACAATCCGGCTTATGACCAT
CCAATACGGAGCTAGCGTTCTGCC -> CAATACGGAGCTAGCGTTCTGCCG
CCAATCGCGATACACCCAGGTTAT -> CAATCGCGATACACCCAGGTTATC
CCACACAGTCTATCCGACACCATA -> CACACAGTCTATCCGACACCATAC
CCACACCCCGCAATTCTACTCTCA -> CACACCCCGCAATTCTACTCTCAT
CCACACGTGCCCAATCGCGATACA -> CACACGTGCCCAATCGCGATACAC
CCACCGGACAAAGGTATGAGCGTT -> CACCGGACAAAGGTATGAGCGTTC
CCACGCTATTTGTTCAACAAGAAG -> CACGCTATTTGTTCAACAAGAAGT
CCACGCTTGTATAGACCGGCCGCA -> CACGCTTGTATAGACCGGCCGCAC
CCACGTACCTTATTAAAATCCCTT -> CACGTACCTTATTAAAATCCCTTA
CCACGTCACCGGTGCTTGACGGTT -> CACGTCACCGGTGCTTGACGGTTA
CCAGAAGCTGGCTCAGAATCTGCT -> CAGAAGCTGGCTCAGAATCTGCTA
CCAGACTATAACTTAGCAGCACAC -> CAGACTATAACTTAGCAGCACACT
CCAGCACGGCCTCTGTGGGGCATG -> CAGCACGGCCTCTGTGGGGCATGT
CCAGCTCAGAGTACACCAAGCGCA -> CAGCTCAGAGTACACCAAGCGCAC
CCAGGAAGATTGTGGAAGTAAAGA -> CAGGAAGATTGTGGAAGTAAAGAA
CCAGGCAAACTGGCCTTAACATGA -> CAGGCAAACTGGCCTTAACATGAC
CCAGGCCCTTCGTAGAACCACGCT -> CAGGCCCTTCGTAGAACCACGCTT
CCAGGGACCTTACGGCAGGCTCTT -> CAGGGACCTTACGGCAGGCTCTTC
CCAGGGCCACACAGTCTATCCGAC -> CAGGGCCACACAGTCTATCCGACA
CCAGGTTATCACGATGCACCAAGA -> CAGGTTATCACGATGCACCAAGAC
CCAGTAGTCTAGTAATAGACTATC -> CAGTAGTCTAGTAATAGACTATCC
CCAGTCCGATCCGAATCTATTGTA -> CAGTCCGATCCGAATCTATTGTAC
CCATAAAAACCACACCCCGCAATT -> CATAAAAACCACACCCCGCAATTC
CCATAAACATCATTCTTATTTCAG -> CATAAACATCATTCTTATTTCAGG
CCATACAAAGATATAAACTCCATA -> CATACAAAGATATAAACTCCATAA
CCATCACTCCAAGCCCCCGCATTT -> CATCACTCCAAGCCCCCGCATTTC
CCATCGGGGTAGCTACACACATGA -> CATCGGGGTAGCTACACACATGAC
CCATGATACACGCGTCTTACTGGA -> CATGATACACGCGTCTTACTGGAT
CCATGCTGTCTTGATTATCCAGGG -> CATGCTGTCTTGATTATCCAGGGC
CCATGTCTTTACGATGCGCCAACT -> CATGTCTTTACGATGCGCCAACTT
CCATTATTTTTAGGCCTCGTCTGC -> CATTATTTTTAGGCCTCGTCTGCA
CCATTGACTCATCGCTCGATAACC -> CATTGACTCATCGCTCGATAACCG
CCATTGGGCACTGTCCCCGCTATC -> CATTGGGCACTGTCCCCGCTATCT
CCCAACTGGTCAGCGGATCGATTA -> CCAACTGGTCAGCGGATCGATTAA
CCCAATACAATCCGGCTTATGACC -> CCAATACAATCCGGCTTATGACCA
CCCAATCGCGATACACCCAGGTTA -> CCAATCGCGATACACCCAGGTTAT
CCCAGACTATAACTTAGCAGCACA -> CCAGACTATAACTTAGCAGCACAC
CCCAGGCCCTTCGTAGAACCACGC -> CCAGGCCCTTCGTAGAACCACGCT
CCCAGGGACCTTACGGCAGGCTCT -> CCAGGGACCTTACGGCAGGCTCTT
CCCAGGTTATCACGATGCACCAAG -> CCAGGTTATCACGATGCACCAAGA
CCCAGTCCGATCCGAATCTATTGT -> CCAGTCCGATCCGAATCTATTGTA
CCCATGATACACGCGTCTTACTGG -> CCATGATACACGCGTCTTACTGGA
CCCCAGACTATAACTTAGCAGCAC -> CCCAGACTATAACTTAGCAGCACA
CCCCAGGCCCTTCGTAGAACCACG -> CCCAGGCCCTTCGTAGAACCACGC
CCCCAGGGACCTTACGGCAGGCTC -> CCCAGGGACCTTACGGCAGGCTCT
CCCCCCGGAGGTCGATCGGAGTGG -> CCCCCGGAGGTCGATCGGAGTGGA
CCCCCGCATATTACCTCTCGAGGC -> CCCCGCATATTACCTCTCGAGGCG
CCCCCGGAGGTCGATCGGAGTGGA -> CCCCGGAGGTCGATCGGAGTGGAG
CCCCGCAATTCTACTCTCATAGAA -> CCCGCAATTCTACTCTCATAGAAA
CCCCGCATATTACCTCTCGAGGCG -> CCCGCATATTACCTCTCGAGGCGA
CCCCGCTATCTAGTGTTTTTGATA -> CCCGCTATCTAGTGTTTTTGATAT
CCCCGGAGGTCGATCGGAGTGGAG -> CCCGGAGGTCGATCGGAGTGGAGG
CCCCTGACCTAAGACTGGACCTTC -> CCCTGACCTAAGACTGGACCTTCT
CCCGCAATTCTACTCTCATAGAAA -> CCGCAATTCTACTCTCATAGAAAA
CCCGCATATTACCTCTCGAGGCGA -> CCGCATATTACCTCTCGAGGCGAG
CCCGCCGTCCTTGATTCACCATTG -> CCGCCGTCCTTGATTCACCATTGG
CCCGCTATCTAGTGTTTTTGATAT -> CCGCTATCTAGTGTTTTTGATATT
CCCGGAGGTCGATCGGAGTGGAGG -> CCGGAGGTCGATCGGAGTGGAGGG
CCCGTCGTGAACTATCGCAAAACC -> CCGTCGTGAACTATCGCAAAACCC
CCCGTGGTGTGTATAAGACAGCTA -> CCGTGGTGTGTATAAGACAGCTAT
CCCGTGTATTGACACTCTGACACT -> CCGTGTATTGACACTCTGACACTT
CCCTCGGGTTCCCCAGGCCCTTCG -> CCTCGGGTTCCCCAGGCCCTTCGT
CCCTGACCTAAGACTGGACCTTCT -> CCTGACCTAAGACTGGACCTTCTA
CCCTTAATAGAAAATTAAAACATC -> CCTTAATAGAAAATTAAAACATCT
CCCTTCGCTAGCTAAGTTGAATCT -> CCTTCGCTAGCTAAGTTGAATCTA
CCCTTCGTAGAACCACGCTTGTAT -> CCTTCGTAGAACCACGCTTGTATA
CCCTTGGACAACATCGGGTTGGTA -> CCTTGGACAACATCGGGTTGGTAC
CCCTTGTAATATCCGGTGTCCGAC -> CCTTGTAATATCCGGTGTCCGACT
CCGAATCTATTGTACCTTTTTACA -> CGAATCTATTGTACCTTTTTACAC
CCGACACCATACAAAGATATAAAC -> CGACACCATACAAAGATATAAACT
CCGACTAATAACTTGTACAAAACT -> CGACTAATAACTTGTACAAAACTT
CCGACTACTCTCTTAACTAATGAC -> CGACTACTCTCTTAACTAATGACC
CCGACTGTGCCTCCGAGCTGCGGA -> CGACTGTGCCTCCGAGCTGCGGAC
CCGAGAACTATGTCGTGTCCAGCT -> CGAGAACTATGTCGTGTCCAGCTC
CCGAGCTGCGGACGATTAAGCTCC -> CGAGCTGCGGACGATTAAGCTCCG
CCGAGCTGGTAGGTAGATACACCT -> CGAGCTGGTAGGTAGATACACCTT
CCGATCCGAATCTATTGTACCTTT -> CGATCCGAATCTATTGTACCTTTT
CCGCAAAAAGAGTGTATCATCGAA -> CGCAAAAAGAGTGTATCATCGAAC
CCGCAAATAGTAGGATAGCTTATG -> CGCAAATAGTAGGATAGCTTATGT
CCGCAATTCTACTCTCATAGAAAA -> CGCAATTCTACTCTCATAGAAAAA
CCGCACGTCACGGACCCAATACAA -> CGCACGTCACGGACCCAATACAAT
CCGCAGAACCGTCTTTAGCCTAGT -> CGCAGAACCGTCTTTAGCCTAGTT
CCGCATATTACCTCTCGAGGCGAG -> CGCATATTACCTCTCGAGGCGAGA
CCGCCGTCCTTGATTCACCATTGG -> CGCCGTCCTTGATTCACCATTGGG
CCGCGAAGTGGGGTAGGCCAACGT -> CGCGAAGTGGGGTAGGCCAACGTC
CCGCTATCTAGTGTTTTTGATATT -> CGCTATCTAGTGTTTTTGATATTT
CCGGAATTAGTGGCTGACGAGTGT -> CGGAATTAGTGGCTGACGAGTGTC
CCGGACAAAGGTATGAGCGTTCCT -> CGGACAAAGGTATGAGCGTTCCTG
CCGGAGGTCGATCGGAGTGGAGGG -> CGGAGGTCGATCGGAGTGGAGGGA
CCGGCCGCACGTCACGGACCCAAT -> CGGCCGCACGTCACGGACCCAATA
CCGGCTTATGACCATCACTCCAAG -> CGGCTTATGACCATCACTCCAAGC
CCGGGGAACAAGGTGACTCCTTCA -> CGGGGAACAAGGTGACTCCTTCAT
CCGGTGCTTGACGGTTACCTTGCC -> CGGTGCTTGACGGTTACCTTGCCC
CCGGTGGATCATTGATGCCAGGCA -> CGGTGGATCATTGATGCCAGGCAA
CCGGTGTCCGACTGTGCCTCCGAG -> CGGTGTCCGACTGTGCCTCCGAGC
CCGGTTGTCCAGGAAGATTGTGGA -> CGGTTGTCCAGGAAGATTGTGGAA
CCGTCCTTGATTCACCATTGGGCA -> CGTCCTTGATTCACCATTGGGCAC
CCGTCGTGAACTATCGCAAAACCC -> CGTCGTGAACTATCGCAAAACCCC
CCGTCTTTAGCCTAGTTAGGCAAC -> CGTCTTTAGCCTAGTTAGGCAACA
CCGTGGTGTGTATAAGACAGCTAT -> CGTGGTGTGTATAAGACAGCTATC
CCGTGTATTGACACTCTGACACTT -> CGTGTATTGACACTCTGACACTTA
CCGTGTGAACAGATGACTCGAGGC -> CGTGTGAACAGATGACTCGAGGCC
CCGTTAGGATCACTTGTGTAAGTC -> CGTTAGGATCACTTGTGTAAGTCT
CCTAAGACTGGACCTTCTATCGGC -> CTAAGACTGGACCTTCTATCGGCT
CCTACATTTATCCCAGTCCGATCC -> CTACATTTATCCCAGTCCGATCCG
CCTAGTTAGGCAACATTGGAGTTG -> CTAGTTAGGCAACATTGGAGTTGC
CCTCACAATCCGTGTGAACAGATG -> CTCACAATCCGTGTGAACAGATGA
CCTCACTAACGCGTCCGCAAATAG -> CTCACTAACGCGTCCGCAAATAGT
CCTCCGAGCTGCGGACGATTAAGC -> CTCCGAGCTGCGGACGATTAAGCT
CCTCGGGTTCCCCAGGCCCTTCGT -> CTCGGGTTCCCCAGGCCCTTCGTA
CCTCGTCTGCACCATGTCTTTACG -> CTCGTCTGCACCATGTCTTTACGA
CCTCTCGAGGCGAGATACCACGTA -> CTCTCGAGGCGAGATACCACGTAC
CCTCTGTGGGGCATGTGCTGAGAT -> CTCTGTGGGGCATGTGCTGAGATA
CCTGACATTGATTGGCAAGTAAAA -> CTGACATTGATTGGCAAGTAAAAT
CCTGACCTAAGACTGGACCTTCTA -> CTGACCTAAGACTGGACCTTCTAT
CCTGGGAGCATCACGACACTGAAC -> CTGGGAGCATCACGACACTGAACG
CCTGGTGGTGGTCTTTTGTCATCT -> CTGGTGGTGGTCTTTTGTCATCTC
CCTGTTAAATTCCAGCACGGCCTC -> CTGTTAAATTCCAGCACGGCCTCT
CCTTAACATGACGTCGTGGAAGTT -> CTTAACATGACGTCGTGGAAGTTC
CCTTAATAGAAAATTAAAACATCT -> CTTAATAGAAAATTAAAACATCTT
CCTTACGGCAGGCTCTTCCAATAC -> CTTACGGCAGGCTCTTCCAATACG
CCTTATTAAAATCCCTTAATAGAA -> CTTATTAAAATCCCTTAATAGAAA
CCTTCATAGGACTAGGACGCCGGA -> CTTCATAGGACTAGGACGCCGGAA
CCTTCATGGTTGCTTTCGTGTGGT -> CTTCATGGTTGCTTTCGTGTGGTA
CCTTCGATAAAATATCAACTGGAC -> CTTCGATAAAATATCAACTGGACC
CCTTCGCTAGCTAAGTTGAATCTA -> CTTCGCTAGCTAAGTTGAATCTAG
CCTTCGTAGAACCACGCTTGTATA -> CTTCGTAGAACCACGCTTGTATAG
CCTTCTATCGGCTGAACTTTACGC -> CTTCTATCGGCTGAACTTTACGCT
CCTTGATTCACCATTGGGCACTGT -> CTTGATTCACCATTGGGCACTGTC
CCTTGCCCCCCGGAGGTCGATCGG -> CTTGCCCCCCGGAGGTCGATCGGA
CCTTGGACAACATCGGGTTGGTAC -> CTTGGACAACATCGGGTTGGTACG
CCTTGGATACCCATGATACACGCG -> CTTGGATACCCATGATACACGCGT
CCTTGTAATATCCGGTGTCCGACT -> CTTGTAATATCCGGTGTCCGACTG
CCTTTGCTGCCGACTACTCTCTTA -> CTTTGCTGCCGACTACTCTCTTAA
CCTTTTTACACGACATGTCCGAGA -> CTTTTTACACGACATGTCCGAGAA
CGAACAGTCACATGCGATATTCCC -> GAACAGTCACATGCGATATTCCCG
CGAAGTCGTCATCCCGTCGTGAAC -> GAAGTCGTCATCCCGTCGTGAACT
CGAAGTGGGGTAGGCCAACGTCAA -> GAAGTGGGGTAGGCCAACGTCAAT
CGAATAAGTGGACGGATCCATGCT -> GAATAAGTGGACGGATCCATGCTG
CGAATCTATTGTACCTTTTTACAC -> GAATCTATTGTACCTTTTTACACG
CGACAAGCTCTTGGAGAACCTCAC -> GACAAGCTCTTGGAGAACCTCACT
CGACACCATACAAAGATATAAACT -> GACACCATACAAAGATATAAACTC
CGACACTGAACGCATGTAACGTAT -> GACACTGAACGCATGTAACGTATC
CGACATGTCCGAGAACTATGTCGT -> GACATGTCCGAGAACTATGTCGTG
CGACCCTTGTAATATCCGGTGTCC -> GACCCTTGTAATATCCGGTGTCCG
CGACGGGGATGAGTGCGACCCTTG -> GACGGGGATGAGTGCGACCCTTGT
CGACTAATAACTTGTACAAAACTT -> GACTAATAACTTGTACAAAACTTA
CGACTACTCTCTTAACTAATGACC -> GACTACTCTCTTAACTAATGACCC
CGACTGTGCCTCCGAGCTGCGGAC -> GACTGTGCCTCCGAGCTGCGGACG
CGAGAACTATGTCGTGTCCAGCTC -> GAGAACTATGTCGTGTCCAGCTCA
CGAGATACCACGTACCTTATTAAA -> GAGATACCACGTACCTTATTAAAA
CGAGCGGTGTGCGGGAGACTAAAA -> GAGCGGTGTGCGGGAGACTAAAAG
CGAGCTGCGGACGATTAAGCTCCG -> GAGCTGCGGACGATTAAGCTCCGC
CGAGCTGGTAGGTAGATACACCTT -> GAGCTGGTAGGTAGATACACCTTT
CGAGGCCCTTCGCTAGCTAAGTTG -> GAGGCCCTTCGCTAGCTAAGTTGA
CGAGGCCTTCGATAAAATATCAAC -> GAGGCCTTCGATAAAATATCAACT
CGAGGCGAGATACCACGTACCTTA -> GAGGCGAGATACCACGTACCTTAT
CGAGGTGTGCAGGGAAAGAAGTCT -> GAGGTGTGCAGGGAAAGAAGTCTC
CGAGTCTGCGAGGTGTGCAGGGAA -> GAGTCTGCGAGGTGTGCAGGGAAA
CGAGTGTCTTAAACCCGTGTATTG -> GAGTGTCTTAAACCCGTGTATTGA
CGATAAAATATCAACTGGACCACG -> GATAAAATATCAACTGGACCACGT
CGATAACCGGGGAACAAGGTGACT -> GATAACCGGGGAACAAGGTGACTC
CGATACACCCAGGTTATCACGATG -> GATACACCCAGGTTATCACGATGC
CGATATTCCCGCCGTCCTTGATTC -> GATATTCCCGCCGTCCTTGATTCA
CGATCCGAATCTATTGTACCTTTT -> GATCCGAATCTATTGTACCTTTTT
CGATCGGAGTGGAGGGAGTAGGGT -> GATCGGAGTGGAGGGAGTAGGGTC
CGATGCACCAAGACTTGCCTCACA -> GATGCACCAAGACTTGCCTCACAA
CGATGCGCCAACTTAACGCTTGAT -> GATGCGCCAACTTAACGCTTGATA
CGATTAAGCTCCGCAAAAAGAGTG -> GATTAAGCTCCGCAAAAAGAGTGT
CGATTAATCTCGCGGAGGTGCAAA -> GATTAATCTCGCGGAGGTGCAAAG
CGATTGCTAGCAACTATCTTCATT -> GATTGCTAGCAACTATCTTCATTA
CGCAAAAAGAGTGTATCATCGAAC -> GCAAAAAGAGTGTATCATCGAACA
CGCAAAACCCCTGACCTAAGACTG -> GCAAAACCCCTGACCTAAGACTGG
CGCAAATAGTAGGATAGCTTATGT -> GCAAATAGTAGGATAGCTTATGTT
CGCAATTCTACTCTCATAGAAAAA -> GCAATTCTACTCTCATAGAAAAAC
CGCACAGAACGGAGTCCACACGTG -> GCACAGAACGGAGTCCACACGTGC
CGCACGAAGTCGTCATCCCGTCGT -> GCACGAAGTCGTCATCCCGTCGTG
CGCACGTCACGGACCCAATACAAT -> GCACGTCACGGACCCAATACAATC
CGCAGAACCGTCTTTAGCCTAGTT -> GCAGAACCGTCTTTAGCCTAGTTA
CGCATATTACCTCTCGAGGCGAGA -> GCATATTACCTCTCGAGGCGAGAT
CGCATGTAACGTATCCTTGGATAC -> GCATGTAACGTATCCTTGGATACC
CGCCAACTTAACGCTTGATATCTC -> GCCAACTTAACGCTTGATATCTCT
CGCCATTATTTTTAGGCCTCGTCT -> GCCATTATTTTTAGGCCTCGTCTG
CGCCGGAATTAGTGGCTGACGAGT -> GCCGGAATTAGTGGCTGACGAGTG
CGCCGGTTGTCCAGGAAGATTGTG -> GCCGGTTGTCCAGGAAGATTGTGG
CGCCGTCCTTGATTCACCATTGGG -> GCCGTCCTTGATTCACCATTGGGC
CGCGAAGTGGGGTAGGCCAACGTC -> GCGAAGTGGGGTAGGCCAACGTCA
CGCGATACACCCAGGTTATCACGA -> GCGATACACCCAGGTTATCACGAT
CGCGGAGGTGCAAAGCTTATTTCT -> GCGGAGGTGCAAAGCTTATTTCTT
CGCGGCAACGACGGGGATGAGTGC -> GCGGCAACGACGGGGATGAGTGCG
CGCGTCCGCAAATAGTAGGATAGC -> GCGTCCGCAAATAGTAGGATAGCT
CGCGTCTTACTGGATTGAGACTCG -> GCGTCTTACTGGATTGAGACTCGA
CGCTAGCTAAGTTGAATCTAGTCT -> GCTAGCTAAGTTGAATCTAGTCTT
CGCTATCTAGTGTTTTTGATATTT -> GCTATCTAGTGTTTTTGATATTTG
CGCTATTTGTTCAACAAGAAGTGA -> GCTATTTGTTCAACAAGAAGTGAA
CGCTCGATAACCGGGGAACAAGGT -> GCTCGATAACCGGGGAACAAGGTG
CGCTCTGCGGGGGACATTGGACAC -> GCTCTGCGGGGGACATTGGACACA
CGCTGCAGCAGTTCTTACCGTTAG -> GCTGCAGCAGTTCTTACCGTTAGG
CGCTTATTCGAATAAGTGGACGGA -> GCTTATTCGAATAAGTGGACGGAT
CGCTTGATATCTCTAGGTTACGCG -> GCTTGATATCTCTAGGTTACGCGG
CGCTTGTATAGACCGGCCGCACGT -> GCTTGTATAGACCGGCCGCACGTC
CGGAATTAGTGGCTGACGAGTGTC -> GGAATTAGTGGCTGACGAGTGTCT
CGGACAAAGGTATGAGCGTTCCTG -> GGACAAAGGTATGAGCGTTCCTGG
CGGACCCAATACAATCCGGCTTAT -> GGACCCAATACAATCCGGCTTATG
CGGACGATTAAGCTCCGCAAAAAG -> GGACGATTAAGCTCCGCAAAAAGA
CGGAGCTAGCGTTCTGCCGACTAA -> GGAGCTAGCGTTCTGCCGACTAAT
CGGAGGTCGATCGGAGTGGAGGGA -> GGAGGTCGATCGGAGTGGAGGGAG
CGGAGGTGCAAAGCTTATTTCTTC -> GGAGGTGCAAAGCTTATTTCTTCT
CGGAGTCCACACGTGCCCAATCGC -> GGAGTCCACACGTGCCCAATCGCG
CGGAGTGGAGGGAGTAGGGTCTGC -> GGAGTGGAGGGAGTAGGGTCTGCG
CGGATCCATGCTGTCTTGATTATC -> GGATCCATGCTGTCTTGATTATCC
CGGATCGATTAATCTCGCGGAGGT -> GGATCGATTAATCTCGCGGAGGTG
CGGCAACGACGGGGATGAGTGCGA -> GGCAACGACGGGGATGAGTGCGAC
CGGCAGGCTCTTCCAATACGGAGC -> GGCAGGCTCTTCCAATACGGAGCT
CGGCCGCACGTCACGGACCCAATA -> GGCCGCACGTCACGGACCCAATAC
CGGCCTCTGTGGGGCATGTGCTGA -> GGCCTCTGTGGGGCATGTGCTGAG
CGGCTGAACTTTACGCTCTGCGGG -> GGCTGAACTTTACGCTCTGCGGGG
CGGCTTATGACCATCACTCCAAGC -> GGCTTATGACCATCACTCCAAGCC
CGGGAGACTAAAAGAAGTCGAGGC -> GGGAGACTAAAAGAAGTCGAGGCC
CGGGGAACAAGGTGACTCCTTCAT -> GGGGAACAAGGTGACTCCTTCATG
CGGGGATGAGTGCGACCCTTGTAA -> GGGGATGAGTGCGACCCTTGTAAT
CGGGGGACATTGGACACACGAGCG -> GGGGGACATTGGACACACGAGCGG
CGGGGTAGCTACACACATGACCAT -> GGGGTAGCTACACACATGACCATT
CGGGTTCCCCAGGCCCTTCGTAGA -> GGGTTCCCCAGGCCCTTCGTAGAA
CGGGTTGGTACGATTGCTAGCAAC -> GGGTTGGTACGATTGCTAGCAACT
CGGTGCTTGACGGTTACCTTGCCC -> GGTGCTTGACGGTTACCTTGCCCC
CGGTGGATAGGATATCATTGGGAC -> GGTGGATAGGATATCATTGGGACT
CGGTGGATCATTGATGCCAGGCAA -> GGTGGATCATTGATGCCAGGCAAA
CGGTGTCCGACTGTGCCTCCGAGC -> GGTGTCCGACTGTGCCTCCGAGCT
CGGTGTGCGGGAGACTAAAAGAAG -> GGTGTGCGGGAGACTAAAAGAAGT
CGGTTACCTTGCCCCCCGGAGGTC -> GGTTACCTTGCCCCCCGGAGGTCG
CGGTTGTCCAGGAAGATTGTGGAA -> GGTTGTCCAGGAAGATTGTGGAAG
CGTAACCTTCATAGGACTAGGACG -> GTAACCTTCATAGGACTAGGACGC
CGTACCTTATTAAAATCCCTTAAT -> GTACCTTATTAAAATCCCTTAATA
CGTAGAACCACGCTTGTATAGACC -> GTAGAACCACGCTTGTATAGACCG
CGTATCAAGTCAACACCATCGGGG -> GTATCAAGTCAACACCATCGGGGT
CGTATCCTTGGATACCCATGATAC -> GTATCCTTGGATACCCATGATACA
CGTCAATATCATTTTAACTCGCTG -> GTCAATATCATTTTAACTCGCTGC
CGTCACCGGTGCTTGACGGTTACC -> GTCACCGGTGCTTGACGGTTACCT
CGTCACGGACCCAATACAATCCGG -> GTCACGGACCCAATACAATCCGGC
CGTCATCCCGTCGTGAACTATCGC -> GTCATCCCGTCGTGAACTATCGCA
CGTCCGCAAATAGTAGGATAGCTT -> GTCCGCAAATAGTAGGATAGCTTA
CGTCCTTGATTCACCATTGGGCAC -> GTCCTTGATTCACCATTGGGCACT
CGTCGTGAACTATCGCAAAACCCC -> GTCGTGAACTATCGCAAAACCCCT
CGTCGTGGAAGTTCTAAATCATAT -> GTCGTGGAAGTTCTAAATCATATC
CGTCTGCACCATGTCTTTACGATG -> GTCTGCACCATGTCTTTACGATGC
CGTCTTACTGGATTGAGACTCGAC -> GTCTTACTGGATTGAGACTCGACA
CGTCTTTAGCCTAGTTAGGCAACA -> GTCTTTAGCCTAGTTAGGCAACAT
CGTGAACTATCGCAAAACCCCTGA -> GTGAACTATCGCAAAACCCCTGAC
CGTGACCCCAGGGACCTTACGGCA -> GTGACCCCAGGGACCTTACGGCAG
CGTGCCCAATCGCGATACACCCAG -> GTGCCCAATCGCGATACACCCAGG
CGTGGAAGTTCTAAATCATATCAC -> GTGGAAGTTCTAAATCATATCACT
CGTGGTGTGTATAAGACAGCTATC -> GTGGTGTGTATAAGACAGCTATCC
CGTGTATTGACACTCTGACACTTA -> GTGTATTGACACTCTGACACTTAA
CGTGTCCAGCTCAGAGTACACCAA -> GTGTCCAGCTCAGAGTACACCAAG
CGTGTGAACAGATGACTCGAGGCC -> GTGTGAACAGATGACTCGAGGCCC
CGTGTGGTATTCTCCAGAAGCTGG -> GTGTGGTATTCTCCAGAAGCTGGC
CGTTAGGATCACTTGTGTAAGTCT -> GTTAGGATCACTTGTGTAAGTCTA
CGTTCCTGGTGGTGGTCTTTTGTC -> GTTCCTGGTGGTGGTCTTTTGTCA
CGTTCTGCCGACTAATAACTTGTA -> GTTCTGCCGACTAATAACTTGTAC
CTAAAAGAAGTCGAGGCCTTCGAT -> TAAAAGAAGTCGAGGCCTTCGATA
CTAAACCACGCTATTTGTTCAACA -> TAAACCACGCTATTTGTTCAACAA
CTAAATCATATCACTAACCACCGG -> TAAATCATATCACTAACCACCGGA
CTAACCACCGGACAAAGGTATGAG -> TAACCACCGGACAAAGGTATGAGC
CTAACGCGTCCGCAAATAGTAGGA -> TAACGCGTCCGCAAATAGTAGGAT
CTAAGACTGGACCTTCTATCGGCT -> TAAGACTGGACCTTCTATCGGCTG
CTAAGTTGAATCTAGTCTTTCTTC -> TAAGTTGAATCTAGTCTTTCTTCA
CTAATAACTTGTACAAAACTTACG -> TAATAACTTGTACAAAACTTACGC
CTAATGACCCTCGGGTTCCCCAGG -> TAATGACCCTCGGGTTCCCCAGGC
CTACACACATGACCATTGACTCAT -> TACACACATGACCATTGACTCATC
CTACATCCCCCGCATATTACCTCT -> TACATCCCCCGCATATTACCTCTC
CTACATTTATCCCAGTCCGATCCG -> TACATTTATCCCAGTCCGATCCGA
CTACTATCTGATCCGAGCTGGTAG -> TACTATCTGATCCGAGCTGGTAGG
CTACTCTCATAGAAAAACAGGCTC -> TACTCTCATAGAAAAACAGGCTCA
CTACTCTCTTAACTAATGACCCTC -> TACTCTCTTAACTAATGACCCTCG
CTAGCAACTATCTTCATTACCAGT -> TAGCAACTATCTTCATTACCAGTA
CTAGCGTTCTGCCGACTAATAACT -> TAGCGTTCTGCCGACTAATAACTT
CTAGCTAAGTTGAATCTAGTCTTT -> TAGCTAAGTTGAATCTAGTCTTTC
CTAGGACGCCGGAATTAGTGGCTG -> TAGGACGCCGGAATTAGTGGCTGA
CTAGGTTACGCGGCAACGACGGGG -> TAGGTTACGCGGCAACGACGGGGA
CTAGTAATAGACTATCCCGTGGTG -> TAGTAATAGACTATCCCGTGGTGT
CTAGTCGTATCAAGTCAACACCAT -> TAGTCGTATCAAGTCAACACCATC
CTAGTCTTTCTTCAGTTCGTAACC -> TAGTCTTTCTTCAGTTCGTAACCT
CTAGTGTTTTTGATATTTGCATAG -> TAGTGTTTTTGATATTTGCATAGC
CTAGTTAGGCAACATTGGAGTTGC -> TAGTTAGGCAACATTGGAGTTGCT
CTATAACTTAGCAGCACACTGAGG -> TATAACTTAGCAGCACACTGAGGT
CTATCCCGTGGTGTGTATAAGACA -> TATCCCGTGGTGTGTATAAGACAG
CTATCCGACACCATACAAAGATAT -> TATCCGACACCATACAAAGATATA
CTATCCTGACATTGATTGGCAAGT -> TATCCTGACATTGATTGGCAAGTA
CTATCGCAAAACCCCTGACCTAAG -> TATCGCAAAACCCCTGACCTAAGA
CTATCGGCTGAACTTTACGCTCTG -> TATCGGCTGAACTTTACGCTCTGC
CTATCTAGTGTTTTTGATATTTGC -> TATCTAGTGTTTTTGATATTTGCA
CTATCTGATCCGAGCTGGTAGGTA -> TATCTGATCCGAGCTGGTAGGTAG
CTATCTTCATTACCAGTAGTCTAG -> TATCTTCATTACCAGTAGTCTAGT
CTATGTCGTGTCCAGCTCAGAGTA -> TATGTCGTGTCCAGCTCAGAGTAC
CTATTGTACCTTTTTACACGACAT -> TATTGTACCTTTTTACACGACATG
CTATTTGTTCAACAAGAAGTGAAG -> TATTTGTTCAACAAGAAGTGAAGC
CTCACAATCCGTGTGAACAGATGA -> TCACAATCCGTGTGAACAGATGAC
CTCACGTGACCCCAGGGACCTTAC -> TCACGTGACCCCAGGGACCTTACG
CTCACTAACGCGTCCGCAAATAGT -> TCACTAACGCGTCCGCAAATAGTA
CTCACTAGTCGTATCAAGTCAACA -> TCACTAGTCGTATCAAGTCAACAC
CTCAGAATCTGCTACATCCCCCGC -> TCAGAATCTGCTACATCCCCCGCA
CTCAGAGTACACCAAGCGCACGAA -> TCAGAGTACACCAAGCGCACGAAG
CTCATAGAAAAACAGGCTCATATG -> TCATAGAAAAACAGGCTCATATGC
CTCATATGCCCAACTGGTCAGCGG -> TCATATGCCCAACTGGTCAGCGGA
CTCATCGCTCGATAACCGGGGAAC -> TCATCGCTCGATAACCGGGGAACA
CTCCAGAAGCTGGCTCAGAATCTG -> TCCAGAAGCTGGCTCAGAATCTGC
CTCCATAAAAACCACACCCCGCAA -> TCCATAAAAACCACACCCCGCAAT
CTCCCTTGGACAACATCGGGTTGG -> TCCCTTGGACAACATCGGGTTGGT
CTCCGAGCTGCGGACGATTAAGCT -> TCCGAGCTGCGGACGATTAAGCTC
CTCCGCAAAAAGAGTGTATCATCG -> TCCGCAAAAAGAGTGTATCATCGA
CTCCTGGGAGCATCACGACACTGA -> TCCTGGGAGCATCACGACACTGAA
CTCCTTCATGGTTGCTTTCGTGTG -> TCCTTCATGGTTGCTTTCGTGTGG
CTCGACAAGCTCTTGGAGAACCTC -> TCGACAAGCTCTTGGAGAACCTCA
CTCGAGGCCCTTCGCTAGCTAAGT -> TCGAGGCCCTTCGCTAGCTAAGTT
CTCGAGGCGAGATACCACGTACCT -> TCGAGGCGAGATACCACGTACCTT
CTCGATAACCGGGGAACAAGGTGA -> TCGATAACCGGGGAACAAGGTGAC
CTCGCGGAGGTGCAAAGCTTATTT -> TCGCGGAGGTGCAAAGCTTATTTC
CTCGCTGCAGCAGTTCTTACCGTT -> TCGCTGCAGCAGTTCTTACCGTTA
CTCGCTTATTCGAATAAGTGGACG -> TCGCTTATTCGAATAAGTGGACGG
CTCGGGTTCCCCAGGCCCTTCGTA -> TCGGGTTCCCCAGGCCCTTCGTAG
CTCGTCTGCACCATGTCTTTACGA -> TCGTCTGCACCATGTCTTTACGAT
CTCTAAACCACGCTATTTGTTCAA -> TCTAAACCACGCTATTTGTTCAAC
CTCTAGGTTACGCGGCAACGACGG -> TCTAGGTTACGCGGCAACGACGGG
CTCTCATAGAAAAACAGGCTCATA -> TCTCATAGAAAAACAGGCTCATAT
CTCTCGAGGCGAGATACCACGTAC -> TCTCGAGGCGAGATACCACGTACC
CTCTCTAAACCACGCTATTTGTTC -> TCTCTAAACCACGCTATTTGTTCA
CTCTCTTAACTAATGACCCTCGGG -> TCTCTTAACTAATGACCCTCGGGT
CTCTGACACTTAAAACGCCGGTTG -> TCTGACACTTAAAACGCCGGTTGT
CTCTGCGGGGGACATTGGACACAC -> TCTGCGGGGGACATTGGACACACG
CTCTGTGGGGCATGTGCTGAGATA -> TCTGTGGGGCATGTGCTGAGATAC
CTCTTAACTAATGACCCTCGGGTT -> TCTTAACTAATGACCCTCGGGTTC
CTCTTCCAATACGGAGCTAGCGTT -> TCTTCCAATACGGAGCTAGCGTTC
CTCTTGGAGAACCTCACTAACGCG -> TCTTGGAGAACCTCACTAACGCGT
CTGAACGCATGTAACGTATCCTTG -> TGAACGCATGTAACGTATCCTTGG
CTGAACTTTACGCTCTGCGGGGGA -> TGAACTTTACGCTCTGCGGGGGAC
CTGACACTTAAAACGCCGGTTGTC -> TGACACTTAAAACGCCGGTTGTCC
CTGACATTGATTGGCAAGTAAAAT -> TGACATTGATTGGCAAGTAAAATC
CTGACCTAAGACTGGACCTTCTAT -> TGACCTAAGACTGGACCTTCTATC
CTGACGAGTGTCTTAAACCCGTGT -> TGACGAGTGTCTTAAACCCGTGTA
CTGAGATACGAGTCTGCGAGGTGT -> TGAGATACGAGTCTGCGAGGTGTG
CTGAGGTTAGTGTCCGCAGAACCG -> TGAGGTTAGTGTCCGCAGAACCGT
CTGATCCGAGCTGGTAGGTAGATA -> TGATCCGAGCTGGTAGGTAGATAC
CTGCACCATGTCTTTACGATGCGC -> TGCACCATGTCTTTACGATGCGCC
CTGCAGCAGTTCTTACCGTTAGGA -> TGCAGCAGTTCTTACCGTTAGGAT
CTGCCGACTAATAACTTGTACAAA -> TGCCGACTAATAACTTGTACAAAA
CTGCCGACTACTCTCTTAACTAAT -> TGCCGACTACTCTCTTAACTAATG
CTGCGAGGTGTGCAGGGAAAGAAG -> TGCGAGGTGTGCAGGGAAAGAAGT
CTGCGGACGATTAAGCTCCGCAAA -> TGCGGACGATTAAGCTCCGCAAAA
CTGCGGGGGACATTGGACACACGA -> TGCGGGGGACATTGGACACACGAG
CTGCGGTGGATAGGATATCATTGG -> TGCGGTGGATAGGATATCATTGGG
CTGCTACATCCCCCGCATATTACC -> TGCTACATCCCCCGCATATTACCT
CTGGAACGCCATTATTTTTAGGCC -> TGGAACGCCATTATTTTTAGGCCT
CTGGACCACGTCACCGGTGCTTGA -> TGGACCACGTCACCGGTGCTTGAC
CTGGACCTTCTATCGGCTGAACTT -> TGGACCTTCTATCGGCTGAACTTT
CTGGATTGAGACTCGACAAGCTCT -> TGGATTGAGACTCGACAAGCTCTT
CTGGCCTTAACATGACGTCGTGGA -> TGGCCTTAACATGACGTCGTGGAA
CTGGCTCAGAATCTGCTACATCCC -> TGGCTCAGAATCTGCTACATCCCC
CTGGGAGCATCACGACACTGAACG -> TGGGAGCATCACGACACTGAACGC
CTGGTAGGTAGATACACCTTTGCT -> TGGTAGGTAGATACACCTTTGCTG
CTGGTCAGCGGATCGATTAATCTC -> TGGTCAGCGGATCGATTAATCTCG
CTGGTGGTGGTCTTTTGTCATCTC -> TGGTGGTGGTCTTTTGTCATCTCC
CTGTCCCCGCTATCTAGTGTTTTT -> TGTCCCCGCTATCTAGTGTTTTTG
CTGTCTTGATTATCCAGGGCCACA -> TGTCTTGATTATCCAGGGCCACAC
CTGTGCCTCCGAGCTGCGGACGAT -> TGTGCCTCCGAGCTGCGGACGATT
CTGTGGGGCATGTGCTGAGATACG -> TGTGGGGCATGTGCTGAGATACGA
CTGTTAAATTCCAGCACGGCCTCT -> TGTTAAATTCCAGCACGGCCTCTG
CTTAAAACGCCGGTTGTCCAGGAA -> TTAAAACGCCGGTTGTCCAGGAAG
CTTAAACCCGTGTATTGACACTCT -> TTAAACCCGTGTATTGACACTCTG
CTTAACATGACGTCGTGGAAGTTC -> TTAACATGACGTCGTGGAAGTTCT
CTTAACGCTTGATATCTCTAGGTT -> TTAACGCTTGATATCTCTAGGTTA
CTTAACTAATGACCCTCGGGTTCC -> TTAACTAATGACCCTCGGGTTCCC
CTTAATAGAAAATTAAAACATCTT -> TTAATAGAAAATTAAAACATCTTG
CTTACCGTTAGGATCACTTGTGTA -> TTACCGTTAGGATCACTTGTGTAA
CTTACGCACAGAACGGAGTCCACA -> TTACGCACAGAACGGAGTCCACAC
CTTACGGCAGGCTCTTCCAATACG -> TTACGGCAGGCTCTTCCAATACGG
CTTACTGGATTGAGACTCGACAAG -> TTACTGGATTGAGACTCGACAAGC
CTTAGCAGCACACTGAGGTTAGTG -> TTAGCAGCACACTGAGGTTAGTGT
CTTATGACCATCACTCCAAGCCCC -> TTATGACCATCACTCCAAGCCCCC
CTTATGTTGCCGCGAAGTGGGGTA -> TTATGTTGCCGCGAAGTGGGGTAG
CTTATTAAAATCCCTTAATAGAAA -> TTATTAAAATCCCTTAATAGAAAA
CTTATTCGAATAAGTGGACGGATC -> TTATTCGAATAAGTGGACGGATCC
CTTATTTCAGGCCCCAGACTATAA -> TTATTTCAGGCCCCAGACTATAAC
CTTATTTCTTCTGGAACGCCATTA -> TTATTTCTTCTGGAACGCCATTAT
CTTCAGTTCGTAACCTTCATAGGA -> TTCAGTTCGTAACCTTCATAGGAC
CTTCATAGGACTAGGACGCCGGAA -> TTCATAGGACTAGGACGCCGGAAT
CTTCATGGTTGCTTTCGTGTGGTA -> TTCATGGTTGCTTTCGTGTGGTAT
CTTCATTACCAGTAGTCTAGTAAT -> TTCATTACCAGTAGTCTAGTAATA
CTTCCAATACGGAGCTAGCGTTCT -> TTCCAATACGGAGCTAGCGTTCTG
CTTCGATAAAATATCAACTGGACC -> TTCGATAAAATATCAACTGGACCA
CTTCGCTAGCTAAGTTGAATCTAG -> TTCGCTAGCTAAGTTGAATCTAGT
CTTCGTAGAACCACGCTTGTATAG -> TTCGTAGAACCACGCTTGTATAGA
CTTCTATCGGCTGAACTTTACGCT -> TTCTATCGGCTGAACTTTACGCTC
CTTCTGGAACGCCATTATTTTTAG -> TTCTGGAACGCCATTATTTTTAGG
CTTGACGGTTACCTTGCCCCCCGG -> TTGACGGTTACCTTGCCCCCCGGA
CTTGATATCTCTAGGTTACGCGGC -> TTGATATCTCTAGGTTACGCGGCA
CTTGATTATCCAGGGCCACACAGT -> TTGATTATCCAGGGCCACACAGTC
CTTGATTCACCATTGGGCACTGTC -> TTGATTCACCATTGGGCACTGTCC
CTTGCCCCCCGGAGGTCGATCGGA -> TTGCCCCCCGGAGGTCGATCGGAG
CTTGCCTCACAATCCGTGTGAACA -> TTGCCTCACAATCCGTGTGAACAG
CTTGGACAACATCGGGTTGGTACG -> TTGGACAACATCGGGTTGGTACGA
CTTGGAGAACCTCACTAACGCGTC -> TTGGAGAACCTCACTAACGCGTCC
CTTGGATACCCATGATACACGCGT -> TTGGATACCCATGATACACGCGTC
CTTGTAATATCCGGTGTCCGACTG -> TTGTAATATCCGGTGTCCGACTGT
CTTGTACAAAACTTACGCACAGAA -> TTGTACAAAACTTACGCACAGAAC
CTTGTATAGACCGGCCGCACGTCA -> TTGTATAGACCGGCCGCACGTCAC
CTTGTCCTGTTAAATTCCAGCACG -> TTGTCCTGTTAAATTCCAGCACGG
CTTGTGTAAGTCTACTATCTGATC -> TTGTGTAAGTCTACTATCTGATCC
CTTTACGATGCGCCAACTTAACGC -> TTTACGATGCGCCAACTTAACGCT
CTTTACGCTCTGCGGGGGACATTG -> TTTACGCTCTGCGGGGGACATTGG
CTTTAGCCTAGTTAGGCAACATTG -> TTTAGCCTAGTTAGGCAACATTGG
CTTTCGTGTGGTATTCTCCAGAAG -> TTTCGTGTGGTATTCTCCAGAAGC
CTTTCTTCAGTTCGTAACCTTCAT -> TTTCTTCAGTTCGTAACCTTCATA
CTTTGCTGCCGACTACTCTCTTAA -> TTTGCTGCCGACTACTCTCTTAAC
CTTTTGTCATCTCCCTTGGACAAC -> TTTTGTCATCTCCCTTGGACAACA
CTTTTTACACGACATGTCCGAGAA -> TTTTTACACGACATGTCCGAGAAC
CTTTTTCCGGTGGATCATTGATGC -> TTTTTCCGGTGGATCATTGATGCC
GAAAAACAGGCTCATATGCCCAAC -> AAAAACAGGCTCATATGCCCAACT
GAAAATTAAAACATCTTGTCCTGT -> AAAATTAAAACATCTTGTCCTGTT
GAAAGAAGTCTCACGTGACCCCAG -> AAAGAAGTCTCACGTGACCCCAGG
GAAAGCTCTCTAAACCACGCTATT -> AAAGCTCTCTAAACCACGCTATTT
GAACAAGGTGACTCCTTCATGGTT -> AACAAGGTGACTCCTTCATGGTTG
GAACAGATGACTCGAGGCCCTTCG -> AACAGATGACTCGAGGCCCTTCGC
GAACAGTCACATGCGATATTCCCG -> AACAGTCACATGCGATATTCCCGC
GAACCACGCTTGTATAGACCGGCC -> AACCACGCTTGTATAGACCGGCCG
GAACCGTCTTTAGCCTAGTTAGGC -> AACCGTCTTTAGCCTAGTTAGGCA
GAACCTCACTAACGCGTCCGCAAA -> AACCTCACTAACGCGTCCGCAAAT
GAACGCATGTAACGTATCCTTGGA -> AACGCATGTAACGTATCCTTGGAT
GAACGCCATTATTTTTAGGCCTCG -> AACGCCATTATTTTTAGGCCTCGT
GAACGGAGTCCACACGTGCCCAAT -> AACGGAGTCCACACGTGCCCAATC
GAACTATCGCAAAACCCCTGACCT -> AACTATCGCAAAACCCCTGACCTA
GAACTATGTCGTGTCCAGCTCAGA -> AACTATGTCGTGTCCAGCTCAGAG
GAACTTTACGCTCTGCGGGGGACA -> AACTTTACGCTCTGCGGGGGACAT
GAAGATTGTGGAAGTAAAGAAAGC -> AAGATTGTGGAAGTAAAGAAAGCT
GAAGCAGGTTCCATAAACATCATT -> AAGCAGGTTCCATAAACATCATTC
GAAGCTGGCTCAGAATCTGCTACA -> AAGCTGGCTCAGAATCTGCTACAT
GAAGTAAAGAAAGCTCTCTAAACC -> AAGTAAAGAAAGCTCTCTAAACCA
GAAGTCGAGGCCTTCGATAAAATA -> AAGTCGAGGCCTTCGATAAAATAT
GAAGTCGTCATCCCGTCGTGAACT -> AAGTCGTCATCCCGTCGTGAACTA
GAAGTCTCACGTGACCCCAGGGAC -> AAGTCTCACGTGACCCCAGGGACC
GAAGTGAAGCAGGTTCCATAAACA -> AAGTGAAGCAGGTTCCATAAACAT
GAAGTGGGGTAGGCCAACGTCAAT -> AAGTGGGGTAGGCCAACGTCAATA
GAAGTTCTAAATCATATCACTAAC -> AAGTTCTAAATCATATCACTAACC
GAATAAGTGGACGGATCCATGCTG -> AATAAGTGGACGGATCCATGCTGT
GAATCTAGTCTTTCTTCAGTTCGT -> AATCTAGTCTTTCTTCAGTTCGTA
GAATCTATTGTACCTTTTTACACG -> AATCTATTGTACCTTTTTACACGA
GAATCTGCTACATCCCCCGCATAT -> AATCTGCTACATCCCCCGCATATT
GAATTAGTGGCTGACGAGTGTCTT -> AATTAGTGGCTGACGAGTGTCTTA
GACAAAGGTATGAGCGTTCCTGGT -> ACAAAGGTATGAGCGTTCCTGGTG
GACAACATCGGGTTGGTACGATTG -> ACAACATCGGGTTGGTACGATTGC
GACAAGCTCTTGGAGAACCTCACT -> ACAAGCTCTTGGAGAACCTCACTA
GACACACGAGCGGTGTGCGGGAGA -> ACACACGAGCGGTGTGCGGGAGAC
GACACCATACAAAGATATAAACTC -> ACACCATACAAAGATATAAACTCC
GACACTCTGACACTTAAAACGCCG -> ACACTCTGACACTTAAAACGCCGG
GACACTGAACGCATGTAACGTATC -> ACACTGAACGCATGTAACGTATCC
GACACTTAAAACGCCGGTTGTCCA -> ACACTTAAAACGCCGGTTGTCCAG
GACAGCTATCCTGACATTGATTGG -> ACAGCTATCCTGACATTGATTGGC
GACATGTCCGAGAACTATGTCGTG -> ACATGTCCGAGAACTATGTCGTGT
GACATTGATTGGCAAGTAAAATCT -> ACATTGATTGGCAAGTAAAATCTC
GACATTGGACACACGAGCGGTGTG -> ACATTGGACACACGAGCGGTGTGC
GACCACGTCACCGGTGCTTGACGG -> ACCACGTCACCGGTGCTTGACGGT
GACCATCACTCCAAGCCCCCGCAT -> ACCATCACTCCAAGCCCCCGCATT
GACCATTGACTCATCGCTCGATAA -> ACCATTGACTCATCGCTCGATAAC
GACCCAATACAATCCGGCTTATGA -> ACCCAATACAATCCGGCTTATGAC
GACCCCAGGGACCTTACGGCAGGC -> ACCCCAGGGACCTTACGGCAGGCT
GACCCTCGGGTTCCCCAGGCCCTT -> ACCCTCGGGTTCCCCAGGCCCTTC
GACCCTTGTAATATCCGGTGTCCG -> ACCCTTGTAATATCCGGTGTCCGA
GACCGGCCGCACGTCACGGACCCA -> ACCGGCCGCACGTCACGGACCCAA
GACCTAAGACTGGACCTTCTATCG -> ACCTAAGACTGGACCTTCTATCGG
GACCTTACGGCAGGCTCTTCCAAT -> ACCTTACGGCAGGCTCTTCCAATA
GACCTTCTATCGGCTGAACTTTAC -> ACCTTCTATCGGCTGAACTTTACG
GACGAGTGTCTTAAACCCGTGTAT -> ACGAGTGTCTTAAACCCGTGTATT
GACGATTAAGCTCCGCAAAAAGAG -> ACGATTAAGCTCCGCAAAAAGAGT
GACGCCGGAATTAGTGGCTGACGA -> ACGCCGGAATTAGTGGCTGACGAG
GACGGATCCATGCTGTCTTGATTA -> ACGGATCCATGCTGTCTTGATTAT
GACGGGGATGAGTGCGACCCTTGT -> ACGGGGATGAGTGCGACCCTTGTA
GACGGTTACCTTGCCCCCCGGAGG -> ACGGTTACCTTGCCCCCCGGAGGT
GACGTCGTGGAAGTTCTAAATCAT -> ACGTCGTGGAAGTTCTAAATCATA
GACTAAAAGAAGTCGAGGCCTTCG -> ACTAAAAGAAGTCGAGGCCTTCGA
GACTAATAACTTGTACAAAACTTA -> ACTAATAACTTGTACAAAACTTAC
GACTACTCTCTTAACTAATGACCC -> ACTACTCTCTTAACTAATGACCCT
GACTAGGACGCCGGAATTAGTGGC -> ACTAGGACGCCGGAATTAGTGGCT
GACTATAACTTAGCAGCACACTGA -> ACTATAACTTAGCAGCACACTGAG
GACTATCCCGTGGTGTGTATAAGA -> ACTATCCCGTGGTGTGTATAAGAC
GACTCACTAGTCGTATCAAGTCAA -> ACTCACTAGTCGTATCAAGTCAAC
GACTCATCGCTCGATAACCGGGGA -> ACTCATCGCTCGATAACCGGGGAA
GACTCCTTCATGGTTGCTTTCGTG -> ACTCCTTCATGGTTGCTTTCGTGT
GACTCGACAAGCTCTTGGAGAACC -> ACTCGACAAGCTCTTGGAGAACCT
GACTCGAGGCCCTTCGCTAGCTAA -> ACTCGAGGCCCTTCGCTAGCTAAG
GACTGGACCTTCTATCGGCTGAAC -> ACTGGACCTTCTATCGGCTGAACT
GACTGTGCCTCCGAGCTGCGGACG -> ACTGTGCCTCCGAGCTGCGGACGA
GACTTGCCTCACAATCCGTGTGAA -> ACTTGCCTCACAATCCGTGTGAAC
GAGAACCTCACTAACGCGTCCGCA -> AGAACCTCACTAACGCGTCCGCAA
GAGAACTATGTCGTGTCCAGCTCA -> AGAACTATGTCGTGTCCAGCTCAG
GAGACTAAAAGAAGTCGAGGCCTT -> AGACTAAAAGAAGTCGAGGCCTTC
GAGACTCGACAAGCTCTTGGAGAA -> AGACTCGACAAGCTCTTGGAGAAC
GAGATACCACGTACCTTATTAAAA -> AGATACCACGTACCTTATTAAAAT
GAGATACGAGTCTGCGAGGTGTGC -> AGATACGAGTCTGCGAGGTGTGCA
GAGCATCACGACACTGAACGCATG -> AGCATCACGACACTGAACGCATGT
GAGCGGTGTGCGGGAGACTAAAAG -> AGCGGTGTGCGGGAGACTAAAAGA
GAGCGTTCCTGGTGGTGGTCTTTT -> AGCGTTCCTGGTGGTGGTCTTTTG
GAGCTAGCGTTCTGCCGACTAATA -> AGCTAGCGTTCTGCCGACTAATAA
GAGCTGCGGACGATTAAGCTCCGC -> AGCTGCGGACGATTAAGCTCCGCA
GAGCTGGTAGGTAGATACACCTTT -> AGCTGGTAGGTAGATACACCTTTG
GAGGCCCTTCGCTAGCTAAGTTGA -> AGGCCCTTCGCTAGCTAAGTTGAA
GAGGCCTTCGATAAAATATCAACT -> AGGCCTTCGATAAAATATCAACTG
GAGGCGAGATACCACGTACCTTAT -> AGGCGAGATACCACGTACCTTATT
GAGGGAGTAGGGTCTGCGGTGGAT -> AGGGAGTAGGGTCTGCGGTGGATA
GAGGTCGATCGGAGTGGAGGGAGT -> AGGTCGATCGGAGTGGAGGGAGTA
GAGGTGCAAAGCTTATTTCTTCTG -> AGGTGCAAAGCTTATTTCTTCTGG
GAGGTGTGCAGGGAAAGAAGTCTC -> AGGTGTGCAGGGAAAGAAGTCTCA
GAGGTTAGTGTCCGCAGAACCGTC -> AGGTTAGTGTCCGCAGAACCGTCT
GAGTACACCAAGCGCACGAAGTCG -> AGTACACCAAGCGCACGAAGTCGT
GAGTAGGGTCTGCGGTGGATAGGA -> AGTAGGGTCTGCGGTGGATAGGAT
GAGTCCACACGTGCCCAATCGCGA -> AGTCCACACGTGCCCAATCGCGAT
GAGTCTGCGAGGTGTGCAGGGAAA -> AGTCTGCGAGGTGTGCAGGGAAAG
GAGTGCGACCCTTGTAATATCCGG -> AGTGCGACCCTTGTAATATCCGGT
GAGTGGAGGGAGTAGGGTCTGCGG -> AGTGGAGGGAGTAGGGTCTGCGGT
GAGTGTATCATCGAACAGTCACAT -> AGTGTATCATCGAACAGTCACATG
GAGTGTCTTAAACCCGTGTATTGA -> AGTGTCTTAAACCCGTGTATTGAC
GAGTTGCTCGCTTATTCGAATAAG -> AGTTGCTCGCTTATTCGAATAAGT
GATAAAATATCAACTGGACCACGT -> ATAAAATATCAACTGGACCACGTC
GATAACCGGGGAACAAGGTGACTC -> ATAACCGGGGAACAAGGTGACTCC
GATACACCCAGGTTATCACGATGC -> ATACACCCAGGTTATCACGATGCA
GATACACCTTTGCTGCCGACTACT -> ATACACCTTTGCTGCCGACTACTC
GATACACGCGTCTTACTGGATTGA -> ATACACGCGTCTTACTGGATTGAG
GATACCACGTACCTTATTAAAATC -> ATACCACGTACCTTATTAAAATCC
GATACCCATGATACACGCGTCTTA -> ATACCCATGATACACGCGTCTTAC
GATACGAGTCTGCGAGGTGTGCAG -> ATACGAGTCTGCGAGGTGTGCAGG
GATAGCTTATGTTGCCGCGAAGTG -> ATAGCTTATGTTGCCGCGAAGTGG
GATAGGATATCATTGGGACTCACT -> ATAGGATATCATTGGGACTCACTA
GATATAAACTCCATAAAAACCACA -> ATATAAACTCCATAAAAACCACAC
GATATCATTGGGACTCACTAGTCG -> ATATCATTGGGACTCACTAGTCGT
GATATCTCTAGGTTACGCGGCAAC -> ATATCTCTAGGTTACGCGGCAACG
GATATTCCCGCCGTCCTTGATTCA -> ATATTCCCGCCGTCCTTGATTCAC
GATATTTGCATAGCTTTTTCCGGT -> ATATTTGCATAGCTTTTTCCGGTG
GATCACTTGTGTAAGTCTACTATC -> ATCACTTGTGTAAGTCTACTATCT
GATCATTGATGCCAGGCAAACTGG -> ATCATTGATGCCAGGCAAACTGGC
GATCCATGCTGTCTTGATTATCCA -> ATCCATGCTGTCTTGATTATCCAG
GATCCGAATCTATTGTACCTTTTT -> ATCCGAATCTATTGTACCTTTTTA
GATCCGAGCTGGTAGGTAGATACA -> ATCCGAGCTGGTAGGTAGATACAC
GATCGATTAATCTCGCGGAGGTGC -> ATCGATTAATCTCGCGGAGGTGCA
GATCGGAGTGGAGGGAGTAGGGTC -> ATCGGAGTGGAGGGAGTAGGGTCT
GATGACTCGAGGCCCTTCGCTAGC -> ATGACTCGAGGCCCTTCGCTAGCT
GATGAGTGCGACCCTTGTAATATC -> ATGAGTGCGACCCTTGTAATATCC
GATGCACCAAGACTTGCCTCACAA -> ATGCACCAAGACTTGCCTCACAAT
GATGCCAGGCAAACTGGCCTTAAC -> ATGCCAGGCAAACTGGCCTTAACA
GATGCGCCAACTTAACGCTTGATA -> ATGCGCCAACTTAACGCTTGATAT
GATTAAGCTCCGCAAAAAGAGTGT -> ATTAAGCTCCGCAAAAAGAGTGTA
GATTAATCTCGCGGAGGTGCAAAG -> ATTAATCTCGCGGAGGTGCAAAGC
GATTATCCAGGGCCACACAGTCTA -> ATTATCCAGGGCCACACAGTCTAT
GATTCACCATTGGGCACTGTCCCC -> ATTCACCATTGGGCACTGTCCCCG
GATTGAGACTCGACAAGCTCTTGG -> ATTGAGACTCGACAAGCTCTTGGA
GATTGCTAGCAACTATCTTCATTA -> ATTGCTAGCAACTATCTTCATTAC
GATTGGCAAGTAAAATCTCCTGGG -> ATTGGCAAGTAAAATCTCCTGGGA
GATTGTGGAAGTAAAGAAAGCTCT -> ATTGTGGAAGTAAAGAAAGCTCTC
GCAAAAAGAGTGTATCATCGAACA -> CAAAAAGAGTGTATCATCGAACAG
GCAAAACCCCTGACCTAAGACTGG -> CAAAACCCCTGACCTAAGACTGGA
GCAAACTGGCCTTAACATGACGTC -> CAAACTGGCCTTAACATGACGTCG
GCAAAGCTTATTTCTTCTGGAACG -> CAAAGCTTATTTCTTCTGGAACGC
GCAAATAGTAGGATAGCTTATGTT -> CAAATAGTAGGATAGCTTATGTTG
GCAACATTGGAGTTGCTCGCTTAT -> CAACATTGGAGTTGCTCGCTTATT
GCAACGACGGGGATGAGTGCGACC -> CAACGACGGGGATGAGTGCGACCC
GCAACTATCTTCATTACCAGTAGT -> CAACTATCTTCATTACCAGTAGTC
GCAAGTAAAATCTCCTGGGAGCAT -> CAAGTAAAATCTCCTGGGAGCATC
GCAATTCTACTCTCATAGAAAAAC -> CAATTCTACTCTCATAGAAAAACA
GCACACTGAGGTTAGTGTCCGCAG -> CACACTGAGGTTAGTGTCCGCAGA
GCACAGAACGGAGTCCACACGTGC -> CACAGAACGGAGTCCACACGTGCC
GCACCAAGACTTGCCTCACAATCC -> CACCAAGACTTGCCTCACAATCCG
GCACCATGTCTTTACGATGCGCCA -> CACCATGTCTTTACGATGCGCCAA
GCACGAAGTCGTCATCCCGTCGTG -> CACGAAGTCGTCATCCCGTCGTGA
GCACGGCCTCTGTGGGGCATGTGC -> CACGGCCTCTGTGGGGCATGTGCT
GCACGTCACGGACCCAATACAATC -> CACGTCACGGACCCAATACAATCC
GCACTGTCCCCGCTATCTAGTGTT -> CACTGTCCCCGCTATCTAGTGTTT
GCAGAACCGTCTTTAGCCTAGTTA -> CAGAACCGTCTTTAGCCTAGTTAG
GCAGCACACTGAGGTTAGTGTCCG -> CAGCACACTGAGGTTAGTGTCCGC
GCAGCAGTTCTTACCGTTAGGATC -> CAGCAGTTCTTACCGTTAGGATCA
GCAGGCTCTTCCAATACGGAGCTA -> CAGGCTCTTCCAATACGGAGCTAG
GCAGGGAAAGAAGTCTCACGTGAC -> CAGGGAAAGAAGTCTCACGTGACC
GCAGGTTCCATAAACATCATTCTT -> CAGGTTCCATAAACATCATTCTTA
GCAGTTCTTACCGTTAGGATCACT -> CAGTTCTTACCGTTAGGATCACTT
GCATAGCTTTTTCCGGTGGATCAT -> CATAGCTTTTTCCGGTGGATCATT
GCATATTACCTCTCGAGGCGAGAT -> CATATTACCTCTCGAGGCGAGATA
GCATCACGACACTGAACGCATGTA -> CATCACGACACTGAACGCATGTAA
GCATGTAACGTATCCTTGGATACC -> CATGTAACGTATCCTTGGATACCC
GCATGTGCTGAGATACGAGTCTGC -> CATGTGCTGAGATACGAGTCTGCG
GCCAACGTCAATATCATTTTAACT -> CCAACGTCAATATCATTTTAACTC
GCCAACTTAACGCTTGATATCTCT -> CCAACTTAACGCTTGATATCTCTA
GCCACACAGTCTATCCGACACCAT -> CCACACAGTCTATCCGACACCATA
GCCAGGCAAACTGGCCTTAACATG -> CCAGGCAAACTGGCCTTAACATGA
GCCATTATTTTTAGGCCTCGTCTG -> CCATTATTTTTAGGCCTCGTCTGC
GCCCAACTGGTCAGCGGATCGATT -> CCCAACTGGTCAGCGGATCGATTA
GCCCAATCGCGATACACCCAGGTT -> CCCAATCGCGATACACCCAGGTTA
GCCCCAGACTATAACTTAGCAGCA -> CCCCAGACTATAACTTAGCAGCAC
GCCCCCCGGAGGTCGATCGGAGTG -> CCCCCCGGAGGTCGATCGGAGTGG
GCCCTTCGCTAGCTAAGTTGAATC -> CCCTTCGCTAGCTAAGTTGAATCT
GCCCTTCGTAGAACCACGCTTGTA -> CCCTTCGTAGAACCACGCTTGTAT
GCCGACTAATAACTTGTACAAAAC -> CCGACTAATAACTTGTACAAAACT
GCCGACTACTCTCTTAACTAATGA -> CCGACTACTCTCTTAACTAATGAC
GCCGCACGTCACGGACCCAATACA -> CCGCACGTCACGGACCCAATACAA
GCCGCGAAGTGGGGTAGGCCAACG -> CCGCGAAGTGGGGTAGGCCAACGT
GCCGGAATTAGTGGCTGACGAGTG -> CCGGAATTAGTGGCTGACGAGTGT
GCCGGTTGTCCAGGAAGATTGTGG -> CCGGTTGTCCAGGAAGATTGTGGA
GCCGTCCTTGATTCACCATTGGGC -> CCGTCCTTGATTCACCATTGGGCA
GCCTAGTTAGGCAACATTGGAGTT -> CCTAGTTAGGCAACATTGGAGTTG
GCCTCACAATCCGTGTGAACAGAT -> CCTCACAATCCGTGTGAACAGATG
GCCTCCGAGCTGCGGACGATTAAG -> CCTCCGAGCTGCGGACGATTAAGC
GCCTCGTCTGCACCATGTCTTTAC -> CCTCGTCTGCACCATGTCTTTACG
GCCTCTGTGGGGCATGTGCTGAGA -> CCTCTGTGGGGCATGTGCTGAGAT
GCCTTAACATGACGTCGTGGAAGT -> CCTTAACATGACGTCGTGGAAGTT
GCCTTCGATAAAATATCAACTGGA -> CCTTCGATAAAATATCAACTGGAC
GCGAAGTGGGGTAGGCCAACGTCA -> CGAAGTGGGGTAGGCCAACGTCAA
GCGACCCTTGTAATATCCGGTGTC -> CGACCCTTGTAATATCCGGTGTCC
GCGAGATACCACGTACCTTATTAA -> CGAGATACCACGTACCTTATTAAA
GCGAGGTGTGCAGGGAAAGAAGTC -> CGAGGTGTGCAGGGAAAGAAGTCT
GCGATACACCCAGGTTATCACGAT -> CGATACACCCAGGTTATCACGATG
GCGATATTCCCGCCGTCCTTGATT -> CGATATTCCCGCCGTCCTTGATTC
GCGCACGAAGTCGTCATCCCGTCG -> CGCACGAAGTCGTCATCCCGTCGT
GCGCCAACTTAACGCTTGATATCT -> CGCCAACTTAACGCTTGATATCTC
GCGGACGATTAAGCTCCGCAAAAA -> CGGACGATTAAGCTCCGCAAAAAG
GCGGAGGTGCAAAGCTTATTTCTT -> CGGAGGTGCAAAGCTTATTTCTTC
GCGGATCGATTAATCTCGCGGAGG -> CGGATCGATTAATCTCGCGGAGGT
GCGGCAACGACGGGGATGAGTGCG -> CGGCAACGACGGGGATGAGTGCGA
GCGGGAGACTAAAAGAAGTCGAGG -> CGGGAGACTAAAAGAAGTCGAGGC
GCGGGGGACATTGGACACACGAGC -> CGGGGGACATTGGACACACGAGCG
GCGGTGGATAGGATATCATTGGGA -> CGGTGGATAGGATATCATTGGGAC
GCGGTGTGCGGGAGACTAAAAGAA -> CGGTGTGCGGGAGACTAAAAGAAG
GCGTCCGCAAATAGTAGGATAGCT -> CGTCCGCAAATAGTAGGATAGCTT
GCGTCTTACTGGATTGAGACTCGA -> CGTCTTACTGGATTGAGACTCGAC
GCGTTCCTGGTGGTGGTCTTTTGT -> CGTTCCTGGTGGTGGTCTTTTGTC
GCGTTCTGCCGACTAATAACTTGT -> CGTTCTGCCGACTAATAACTTGTA
GCTAAGTTGAATCTAGTCTTTCTT -> CTAAGTTGAATCTAGTCTTTCTTC
GCTACACACATGACCATTGACTCA -> CTACACACATGACCATTGACTCAT
GCTACATCCCCCGCATATTACCTC -> CTACATCCCCCGCATATTACCTCT
GCTAGCAACTATCTTCATTACCAG -> CTAGCAACTATCTTCATTACCAGT
GCTAGCGTTCTGCCGACTAATAAC -> CTAGCGTTCTGCCGACTAATAACT
GCTAGCTAAGTTGAATCTAGTCTT -> CTAGCTAAGTTGAATCTAGTCTTT
GCTATCCTGACATTGATTGGCAAG -> CTATCCTGACATTGATTGGCAAGT
GCTATCTAGTGTTTTTGATATTTG -> CTATCTAGTGTTTTTGATATTTGC
GCTATTTGTTCAACAAGAAGTGAA -> CTATTTGTTCAACAAGAAGTGAAG
GCTCAGAATCTGCTACATCCCCCG -> CTCAGAATCTGCTACATCCCCCGC
GCTCAGAGTACACCAAGCGCACGA -> CTCAGAGTACACCAAGCGCACGAA
GCTCATATGCCCAACTGGTCAGCG -> CTCATATGCCCAACTGGTCAGCGG
GCTCCGCAAAAAGAGTGTATCATC -> CTCCGCAAAAAGAGTGTATCATCG
GCTCGATAACCGGGGAACAAGGTG -> CTCGATAACCGGGGAACAAGGTGA
GCTCGCTTATTCGAATAAGTGGAC -> CTCGCTTATTCGAATAAGTGGACG
GCTCTCTAAACCACGCTATTTGTT -> CTCTCTAAACCACGCTATTTGTTC
GCTCTGCGGGGGACATTGGACACA -> CTCTGCGGGGGACATTGGACACAC
GCTCTTCCAATACGGAGCTAGCGT -> CTCTTCCAATACGGAGCTAGCGTT
GCTCTTGGAGAACCTCACTAACGC -> CTCTTGGAGAACCTCACTAACGCG
GCTGAACTTTACGCTCTGCGGGGG -> CTGAACTTTACGCTCTGCGGGGGA
GCTGACGAGTGTCTTAAACCCGTG -> CTGACGAGTGTCTTAAACCCGTGT
GCTGAGATACGAGTCTGCGAGGTG -> CTGAGATACGAGTCTGCGAGGTGT
GCTGCAGCAGTTCTTACCGTTAGG -> CTGCAGCAGTTCTTACCGTTAGGA
GCTGCCGACTACTCTCTTAACTAA -> CTGCCGACTACTCTCTTAACTAAT
GCTGCGGACGATTAAGCTCCGCAA -> CTGCGGACGATTAAGCTCCGCAAA
GCTGGCTCAGAATCTGCTACATCC -> CTGGCTCAGAATCTGCTACATCCC
GCTGGTAGGTAGATACACCTTTGC -> CTGGTAGGTAGATACACCTTTGCT
GCTGTCTTGATTATCCAGGGCCAC -> CTGTCTTGATTATCCAGGGCCACA
GCTTATGACCATCACTCCAAGCCC -> CTTATGACCATCACTCCAAGCCCC
GCTTATGTTGCCGCGAAGTGGGGT -> CTTATGTTGCCGCGAAGTGGGGTA
GCTTATTCGAATAAGTGGACGGAT -> CTTATTCGAATAAGTGGACGGATC
GCTTATTTCTTCTGGAACGCCATT -> CTTATTTCTTCTGGAACGCCATTA
GCTTGACGGTTACCTTGCCCCCCG -> CTTGACGGTTACCTTGCCCCCCGG
GCTTGATATCTCTAGGTTACGCGG -> CTTGATATCTCTAGGTTACGCGGC
GCTTGTATAGACCGGCCGCACGTC -> CTTGTATAGACCGGCCGCACGTCA
GCTTTCGTGTGGTATTCTCCAGAA -> CTTTCGTGTGGTATTCTCCAGAAG
GCTTTTTCCGGTGGATCATTGATG -> CTTTTTCCGGTGGATCATTGATGC
GGAAAGAAGTCTCACGTGACCCCA -> GAAAGAAGTCTCACGTGACCCCAG
GGAACAAGGTGACTCCTTCATGGT -> GAACAAGGTGACTCCTTCATGGTT
GGAACGCCATTATTTTTAGGCCTC -> GAACGCCATTATTTTTAGGCCTCG
GGAAGATTGTGGAAGTAAAGAAAG -> GAAGATTGTGGAAGTAAAGAAAGC
GGAAGTAAAGAAAGCTCTCTAAAC -> GAAGTAAAGAAAGCTCTCTAAACC
GGAAGTTCTAAATCATATCACTAA -> GAAGTTCTAAATCATATCACTAAC
GGAATTAGTGGCTGACGAGTGTCT -> GAATTAGTGGCTGACGAGTGTCTT
GGACAAAGGTATGAGCGTTCCTGG -> GACAAAGGTATGAGCGTTCCTGGT
GGACAACATCGGGTTGGTACGATT -> GACAACATCGGGTTGGTACGATTG
GGACACACGAGCGGTGTGCGGGAG -> GACACACGAGCGGTGTGCGGGAGA
GGACATTGGACACACGAGCGGTGT -> GACATTGGACACACGAGCGGTGTG
GGACCACGTCACCGGTGCTTGACG -> GACCACGTCACCGGTGCTTGACGG
GGACCCAATACAATCCGGCTTATG -> GACCCAATACAATCCGGCTTATGA
GGACCTTACGGCAGGCTCTTCCAA -> GACCTTACGGCAGGCTCTTCCAAT
GGACCTTCTATCGGCTGAACTTTA -> GACCTTCTATCGGCTGAACTTTAC
GGACGATTAAGCTCCGCAAAAAGA -> GACGATTAAGCTCCGCAAAAAGAG
GGACGCCGGAATTAGTGGCTGACG -> GACGCCGGAATTAGTGGCTGACGA
GGACGGATCCATGCTGTCTTGATT -> GACGGATCCATGCTGTCTTGATTA
GGACTAGGACGCCGGAATTAGTGG -> GACTAGGACGCCGGAATTAGTGGC
GGACTCACTAGTCGTATCAAGTCA -> GACTCACTAGTCGTATCAAGTCAA
GGAGAACCTCACTAACGCGTCCGC -> GAGAACCTCACTAACGCGTCCGCA
GGAGACTAAAAGAAGTCGAGGCCT -> GAGACTAAAAGAAGTCGAGGCCTT
GGAGCATCACGACACTGAACGCAT -> GAGCATCACGACACTGAACGCATG
GGAGCTAGCGTTCTGCCGACTAAT -> GAGCTAGCGTTCTGCCGACTAATA
GGAGGGAGTAGGGTCTGCGGTGGA -> GAGGGAGTAGGGTCTGCGGTGGAT
GGAGGTCGATCGGAGTGGAGGGAG -> GAGGTCGATCGGAGTGGAGGGAGT
GGAGGTGCAAAGCTTATTTCTTCT -> GAGGTGCAAAGCTTATTTCTTCTG
GGAGTAGGGTCTGCGGTGGATAGG -> GAGTAGGGTCTGCGGTGGATAGGA
GGAGTCCACACGTGCCCAATCGCG -> GAGTCCACACGTGCCCAATCGCGA
GGAGTGGAGGGAGTAGGGTCTGCG -> GAGTGGAGGGAGTAGGGTCTGCGG
GGAGTTGCTCGCTTATTCGAATAA -> GAGTTGCTCGCTTATTCGAATAAG
GGATACCCATGATACACGCGTCTT -> GATACCCATGATACACGCGTCTTA
GGATAGCTTATGTTGCCGCGAAGT -> GATAGCTTATGTTGCCGCGAAGTG
GGATAGGATATCATTGGGACTCAC -> GATAGGATATCATTGGGACTCACT
GGATATCATTGGGACTCACTAGTC -> GATATCATTGGGACTCACTAGTCG
GGATCACTTGTGTAAGTCTACTAT -> GATCACTTGTGTAAGTCTACTATC
GGATCATTGATGCCAGGCAAACTG -> GATCATTGATGCCAGGCAAACTGG
GGATCCATGCTGTCTTGATTATCC -> GATCCATGCTGTCTTGATTATCCA
GGATCGATTAATCTCGCGGAGGTG -> GATCGATTAATCTCGCGGAGGTGC
GGATGAGTGCGACCCTTGTAATAT -> GATGAGTGCGACCCTTGTAATATC
GGATTGAGACTCGACAAGCTCTTG -> GATTGAGACTCGACAAGCTCTTGG
GGCAAACTGGCCTTAACATGACGT -> GCAAACTGGCCTTAACATGACGTC
GGCAACATTGGAGTTGCTCGCTTA -> GCAACATTGGAGTTGCTCGCTTAT
GGCAACGACGGGGATGAGTGCGAC -> GCAACGACGGGGATGAGTGCGACC
GGCAAGTAAAATCTCCTGGGAGCA -> GCAAGTAAAATCTCCTGGGAGCAT
GGCACTGTCCCCGCTATCTAGTGT -> GCACTGTCCCCGCTATCTAGTGTT
GGCAGGCTCTTCCAATACGGAGCT -> GCAGGCTCTTCCAATACGGAGCTA
GGCATGTGCTGAGATACGAGTCTG -> GCATGTGCTGAGATACGAGTCTGC
GGCCAACGTCAATATCATTTTAAC -> GCCAACGTCAATATCATTTTAACT
GGCCACACAGTCTATCCGACACCA -> GCCACACAGTCTATCCGACACCAT
GGCCCCAGACTATAACTTAGCAGC -> GCCCCAGACTATAACTTAGCAGCA
GGCCCTTCGCTAGCTAAGTTGAAT -> GCCCTTCGCTAGCTAAGTTGAATC
GGCCCTTCGTAGAACCACGCTTGT -> GCCCTTCGTAGAACCACGCTTGTA
GGCCGCACGTCACGGACCCAATAC -> GCCGCACGTCACGGACCCAATACA
GGCCTCGTCTGCACCATGTCTTTA -> GCCTCGTCTGCACCATGTCTTTAC
GGCCTCTGTGGGGCATGTGCTGAG -> GCCTCTGTGGGGCATGTGCTGAGA
GGCCTTAACATGACGTCGTGGAAG -> GCCTTAACATGACGTCGTGGAAGT
GGCCTTCGATAAAATATCAACTGG -> GCCTTCGATAAAATATCAACTGGA
GGCGAGATACCACGTACCTTATTA -> GCGAGATACCACGTACCTTATTAA
GGCTCAGAATCTGCTACATCCCCC -> GCTCAGAATCTGCTACATCCCCCG
GGCTCATATGCCCAACTGGTCAGC -> GCTCATATGCCCAACTGGTCAGCG
GGCTCTTCCAATACGGAGCTAGCG -> GCTCTTCCAATACGGAGCTAGCGT
GGCTGAACTTTACGCTCTGCGGGG -> GCTGAACTTTACGCTCTGCGGGGG
GGCTGACGAGTGTCTTAAACCCGT -> GCTGACGAGTGTCTTAAACCCGTG
GGCTTATGACCATCACTCCAAGCC -> GCTTATGACCATCACTCCAAGCCC
GGGAAAGAAGTCTCACGTGACCCC -> GGAAAGAAGTCTCACGTGACCCCA
GGGAACAAGGTGACTCCTTCATGG -> GGAACAAGGTGACTCCTTCATGGT
GGGACATTGGACACACGAGCGGTG -> GGACATTGGACACACGAGCGGTGT
GGGACCTTACGGCAGGCTCTTCCA -> GGACCTTACGGCAGGCTCTTCCAA
GGGACTCACTAGTCGTATCAAGTC -> GGACTCACTAGTCGTATCAAGTCA
GGGAGACTAAAAGAAGTCGAGGCC -> GGAGACTAAAAGAAGTCGAGGCCT
GGGAGCATCACGACACTGAACGCA -> GGAGCATCACGACACTGAACGCAT
GGGAGTAGGGTCTGCGGTGGATAG -> GGAGTAGGGTCTGCGGTGGATAGG
GGGATGAGTGCGACCCTTGTAATA -> GGATGAGTGCGACCCTTGTAATAT
GGGCACTGTCCCCGCTATCTAGTG -> GGCACTGTCCCCGCTATCTAGTGT
GGGCATGTGCTGAGATACGAGTCT -> GGCATGTGCTGAGATACGAGTCTG
GGGCCACACAGTCTATCCGACACC -> GGCCACACAGTCTATCCGACACCA
GGGGAACAAGGTGACTCCTTCATG -> GGGAACAAGGTGACTCCTTCATGG
GGGGACATTGGACACACGAGCGGT -> GGGACATTGGACACACGAGCGGTG
GGGGATGAGTGCGACCCTTGTAAT -> GGGATGAGTGCGACCCTTGTAATA
GGGGCATGTGCTGAGATACGAGTC -> GGGCATGTGCTGAGATACGAGTCT
GGGGGACATTGGACACACGAGCGG -> GGGGACATTGGACACACGAGCGGT
GGGGTAGCTACACACATGACCATT -> GGGTAGCTACACACATGACCATTG
GGGGTAGGCCAACGTCAATATCAT -> GGGTAGGCCAACGTCAATATCATT
GGGTAGCTACACACATGACCATTG -> GGTAGCTACACACATGACCATTGA
GGGTAGGCCAACGTCAATATCATT -> GGTAGGCCAACGTCAATATCATTT
GGGTCTGCGGTGGATAGGATATCA -> GGTCTGCGGTGGATAGGATATCAT
GGGTTCCCCAGGCCCTTCGTAGAA -> GGTTCCCCAGGCCCTTCGTAGAAC
GGGTTGGTACGATTGCTAGCAACT -> GGTTGGTACGATTGCTAGCAACTA
GGTACGATTGCTAGCAACTATCTT -> GTACGATTGCTAGCAACTATCTTC
GGTAGATACACCTTTGCTGCCGAC -> GTAGATACACCTTTGCTGCCGACT
GGTAGCTACACACATGACCATTGA -> GTAGCTACACACATGACCATTGAC
GGTAGGCCAACGTCAATATCATTT -> GTAGGCCAACGTCAATATCATTTT
GGTAGGTAGATACACCTTTGCTGC -> GTAGGTAGATACACCTTTGCTGCC
GGTATGAGCGTTCCTGGTGGTGGT -> GTATGAGCGTTCCTGGTGGTGGTC
GGTATTCTCCAGAAGCTGGCTCAG -> GTATTCTCCAGAAGCTGGCTCAGA
GGTCAGCGGATCGATTAATCTCGC -> GTCAGCGGATCGATTAATCTCGCG
GGTCGATCGGAGTGGAGGGAGTAG -> GTCGATCGGAGTGGAGGGAGTAGG
GGTCTGCGGTGGATAGGATATCAT -> GTCTGCGGTGGATAGGATATCATT
GGTCTTTTGTCATCTCCCTTGGAC -> GTCTTTTGTCATCTCCCTTGGACA
GGTGACTCCTTCATGGTTGCTTTC -> GTGACTCCTTCATGGTTGCTTTCG
GGTGCAAAGCTTATTTCTTCTGGA -> GTGCAAAGCTTATTTCTTCTGGAA
GGTGCTTGACGGTTACCTTGCCCC -> GTGCTTGACGGTTACCTTGCCCCC
GGTGGATAGGATATCATTGGGACT -> GTGGATAGGATATCATTGGGACTC
GGTGGATCATTGATGCCAGGCAAA -> GTGGATCATTGATGCCAGGCAAAC
GGTGGTCTTTTGTCATCTCCCTTG -> GTGGTCTTTTGTCATCTCCCTTGG
GGTGGTGGTCTTTTGTCATCTCCC -> GTGGTGGTCTTTTGTCATCTCCCT
GGTGTCCGACTGTGCCTCCGAGCT -> GTGTCCGACTGTGCCTCCGAGCTG
GGTGTGCAGGGAAAGAAGTCTCAC -> GTGTGCAGGGAAAGAAGTCTCACG
GGTGTGCGGGAGACTAAAAGAAGT -> GTGTGCGGGAGACTAAAAGAAGTC
GGTGTGTATAAGACAGCTATCCTG -> GTGTGTATAAGACAGCTATCCTGA
GGTTACCTTGCCCCCCGGAGGTCG -> GTTACCTTGCCCCCCGGAGGTCGA
GGTTACGCGGCAACGACGGGGATG -> GTTACGCGGCAACGACGGGGATGA
GGTTAGTGTCCGCAGAACCGTCTT -> GTTAGTGTCCGCAGAACCGTCTTT
GGTTATCACGATGCACCAAGACTT -> GTTATCACGATGCACCAAGACTTG
GGTTCCATAAACATCATTCTTATT -> GTTCCATAAACATCATTCTTATTT
GGTTCCCCAGGCCCTTCGTAGAAC -> GTTCCCCAGGCCCTTCGTAGAACC
GGTTGCTTTCGTGTGGTATTCTCC -> GTTGCTTTCGTGTGGTATTCTCCA
GGTTGGTACGATTGCTAGCAACTA -> GTTGGTACGATTGCTAGCAACTAT
GGTTGTCCAGGAAGATTGTGGAAG -> GTTGTCCAGGAAGATTGTGGAAGT
GTAAAATCTCCTGGGAGCATCACG -> TAAAATCTCCTGGGAGCATCACGA
GTAAAGAAAGCTCTCTAAACCACG -> TAAAGAAAGCTCTCTAAACCACGC
GTAACCTTCATAGGACTAGGACGC -> TAACCTTCATAGGACTAGGACGCC
GTAACGTATCCTTGGATACCCATG -> TAACGTATCCTTGGATACCCATGA
GTAAGTCTACTATCTGATCCGAGC -> TAAGTCTACTATCTGATCCGAGCT
GTAATAGACTATCCCGTGGTGTGT -> TAATAGACTATCCCGTGGTGTGTA
GTAATATCCGGTGTCCGACTGTGC -> TAATATCCGGTGTCCGACTGTGCC
GTACAAAACTTACGCACAGAACGG -> TACAAAACTTACGCACAGAACGGA
GTACACCAAGCGCACGAAGTCGTC -> TACACCAAGCGCACGAAGTCGTCA
GTACCTTATTAAAATCCCTTAATA -> TACCTTATTAAAATCCCTTAATAG
GTACCTTTTTACACGACATGTCCG -> TACCTTTTTACACGACATGTCCGA
GTACGATTGCTAGCAACTATCTTC -> TACGATTGCTAGCAACTATCTTCA
GTAGAACCACGCTTGTATAGACCG -> TAGAACCACGCTTGTATAGACCGG
GTAGATACACCTTTGCTGCCGACT -> TAGATACACCTTTGCTGCCGACTA
GTAGCTACACACATGACCATTGAC -> TAGCTACACACATGACCATTGACT
GTAGGATAGCTTATGTTGCCGCGA -> TAGGATAGCTTATGTTGCCGCGAA
GTAGGCCAACGTCAATATCATTTT -> TAGGCCAACGTCAATATCATTTTA
GTAGGGTCTGCGGTGGATAGGATA -> TAGGGTCTGCGGTGGATAGGATAT
GTAGGTAGATACACCTTTGCTGCC -> TAGGTAGATACACCTTTGCTGCCG
GTAGTCTAGTAATAGACTATCCCG -> TAGTCTAGTAATAGACTATCCCGT
GTATAAGACAGCTATCCTGACATT -> TATAAGACAGCTATCCTGACATTG
GTATAGACCGGCCGCACGTCACGG -> TATAGACCGGCCGCACGTCACGGA
GTATCAAGTCAACACCATCGGGGT -> TATCAAGTCAACACCATCGGGGTA
GTATCATCGAACAGTCACATGCGA -> TATCATCGAACAGTCACATGCGAT
GTATCCTTGGATACCCATGATACA -> TATCCTTGGATACCCATGATACAC
GTATGAGCGTTCCTGGTGGTGGTC -> TATGAGCGTTCCTGGTGGTGGTCT
GTATTCTCCAGAAGCTGGCTCAGA -> TATTCTCCAGAAGCTGGCTCAGAA
GTATTGACACTCTGACACTTAAAA -> TATTGACACTCTGACACTTAAAAC
GTCAACACCATCGGGGTAGCTACA -> TCAACACCATCGGGGTAGCTACAC
GTCAATATCATTTTAACTCGCTGC -> TCAATATCATTTTAACTCGCTGCA
GTCACATGCGATATTCCCGCCGTC -> TCACATGCGATATTCCCGCCGTCC
GTCACCGGTGCTTGACGGTTACCT -> TCACCGGTGCTTGACGGTTACCTT
GTCACGGACCCAATACAATCCGGC -> TCACGGACCCAATACAATCCGGCT
GTCAGCGGATCGATTAATCTCGCG -> TCAGCGGATCGATTAATCTCGCGG
GTCATCCCGTCGTGAACTATCGCA -> TCATCCCGTCGTGAACTATCGCAA
GTCATCTCCCTTGGACAACATCGG -> TCATCTCCCTTGGACAACATCGGG
GTCCACACGTGCCCAATCGCGATA -> TCCACACGTGCCCAATCGCGATAC
GTCCAGCTCAGAGTACACCAAGCG -> TCCAGCTCAGAGTACACCAAGCGC
GTCCAGGAAGATTGTGGAAGTAAA -> TCCAGGAAGATTGTGGAAGTAAAG
GTCCCCGCTATCTAGTGTTTTTGA -> TCCCCGCTATCTAGTGTTTTTGAT
GTCCGACTGTGCCTCCGAGCTGCG -> TCCGACTGTGCCTCCGAGCTGCGG
GTCCGAGAACTATGTCGTGTCCAG -> TCCGAGAACTATGTCGTGTCCAGC
GTCCGATCCGAATCTATTGTACCT -> TCCGATCCGAATCTATTGTACCTT
GTCCGCAAATAGTAGGATAGCTTA -> TCCGCAAATAGTAGGATAGCTTAT
GTCCGCAGAACCGTCTTTAGCCTA -> TCCGCAGAACCGTCTTTAGCCTAG
GTCCTGTTAAATTCCAGCACGGCC -> TCCTGTTAAATTCCAGCACGGCCT
GTCCTTGATTCACCATTGGGCACT -> TCCTTGATTCACCATTGGGCACTG
GTCGAGGCCTTCGATAAAATATCA -> TCGAGGCCTTCGATAAAATATCAA
GTCGATCGGAGTGGAGGGAGTAGG -> TCGATCGGAGTGGAGGGAGTAGGG
GTCGTATCAAGTCAACACCATCGG -> TCGTATCAAGTCAACACCATCGGG
GTCGTCATCCCGTCGTGAACTATC -> TCGTCATCCCGTCGTGAACTATCG
GTCGTGAACTATCGCAAAACCCCT -> TCGTGAACTATCGCAAAACCCCTG
GTCGTGGAAGTTCTAAATCATATC -> TCGTGGAAGTTCTAAATCATATCA
GTCGTGTCCAGCTCAGAGTACACC -> TCGTGTCCAGCTCAGAGTACACCA
GTCTACTATCTGATCCGAGCTGGT -> TCTACTATCTGATCCGAGCTGGTA
GTCTAGTAATAGACTATCCCGTGG -> TCTAGTAATAGACTATCCCGTGGT
GTCTATCCGACACCATACAAAGAT -> TCTATCCGACACCATACAAAGATA
GTCTCACGTGACCCCAGGGACCTT -> TCTCACGTGACCCCAGGGACCTTA
GTCTGCACCATGTCTTTACGATGC -> TCTGCACCATGTCTTTACGATGCG
GTCTGCGAGGTGTGCAGGGAAAGA -> TCTGCGAGGTGTGCAGGGAAAGAA
GTCTGCGGTGGATAGGATATCATT -> TCTGCGGTGGATAGGATATCATTG
GTCTTAAACCCGTGTATTGACACT -> TCTTAAACCCGTGTATTGACACTC
GTCTTACTGGATTGAGACTCGACA -> TCTTACTGGATTGAGACTCGACAA
GTCTTGATTATCCAGGGCCACACA -> TCTTGATTATCCAGGGCCACACAG
GTCTTTACGATGCGCCAACTTAAC -> TCTTTACGATGCGCCAACTTAACG
GTCTTTAGCCTAGTTAGGCAACAT -> TCTTTAGCCTAGTTAGGCAACATT
GTCTTTCTTCAGTTCGTAACCTTC -> TCTTTCTTCAGTTCGTAACCTTCA
GTCTTTTGTCATCTCCCTTGGACA -> TCTTTTGTCATCTCCCTTGGACAA
GTGAACAGATGACTCGAGGCCCTT -> TGAACAGATGACTCGAGGCCCTTC
GTGAACTATCGCAAAACCCCTGAC -> TGAACTATCGCAAAACCCCTGACC
GTGAAGCAGGTTCCATAAACATCA -> TGAAGCAGGTTCCATAAACATCAT
GTGACCCCAGGGACCTTACGGCAG -> TGACCCCAGGGACCTTACGGCAGG
GTGACTCCTTCATGGTTGCTTTCG -> TGACTCCTTCATGGTTGCTTTCGT
GTGCAAAGCTTATTTCTTCTGGAA -> TGCAAAGCTTATTTCTTCTGGAAC
GTGCAGGGAAAGAAGTCTCACGTG -> TGCAGGGAAAGAAGTCTCACGTGA
GTGCCCAATCGCGATACACCCAGG -> TGCCCAATCGCGATACACCCAGGT
GTGCCTCCGAGCTGCGGACGATTA -> TGCCTCCGAGCTGCGGACGATTAA
GTGCGACCCTTGTAATATCCGGTG -> TGCGACCCTTGTAATATCCGGTGT
GTGCGGGAGACTAAAAGAAGTCGA -> TGCGGGAGACTAAAAGAAGTCGAG
GTGCTGAGATACGAGTCTGCGAGG -> TGCTGAGATACGAGTCTGCGAGGT
GTGCTTGACGGTTACCTTGCCCCC -> TGCTTGACGGTTACCTTGCCCCCC
GTGGAAGTAAAGAAAGCTCTCTAA -> TGGAAGTAAAGAAAGCTCTCTAAA
GTGGAAGTTCTAAATCATATCACT -> TGGAAGTTCTAAATCATATCACTA
GTGGACGGATCCATGCTGTCTTGA -> TGGACGGATCCATGCTGTCTTGAT
GTGGAGGGAGTAGGGTCTGCGGTG -> TGGAGGGAGTAGGGTCTGCGGTGG
GTGGATAGGATATCATTGGGACTC -> TGGATAGGATATCATTGGGACTCA
GTGGATCATTGATGCCAGGCAAAC -> TGGATCATTGATGCCAGGCAAACT
GTGGCTGACGAGTGTCTTAAACCC -> TGGCTGACGAGTGTCTTAAACCCG
GTGGGGCATGTGCTGAGATACGAG -> TGGGGCATGTGCTGAGATACGAGT
GTGGGGTAGGCCAACGTCAATATC -> TGGGGTAGGCCAACGTCAATATCA
GTGGTATTCTCCAGAAGCTGGCTC -> TGGTATTCTCCAGAAGCTGGCTCA
GTGGTCTTTTGTCATCTCCCTTGG -> TGGTCTTTTGTCATCTCCCTTGGA
GTGGTGGTCTTTTGTCATCTCCCT -> TGGTGGTCTTTTGTCATCTCCCTT
GTGGTGTGTATAAGACAGCTATCC -> TGGTGTGTATAAGACAGCTATCCT
GTGTAAGTCTACTATCTGATCCGA -> TGTAAGTCTACTATCTGATCCGAG
GTGTATAAGACAGCTATCCTGACA -> TGTATAAGACAGCTATCCTGACAT
GTGTATCATCGAACAGTCACATGC -> TGTATCATCGAACAGTCACATGCG
GTGTATTGACACTCTGACACTTAA -> TGTATTGACACTCTGACACTTAAA
GTGTCCAGCTCAGAGTACACCAAG -> TGTCCAGCTCAGAGTACACCAAGC
GTGTCCGACTGTGCCTCCGAGCTG -> TGTCCGACTGTGCCTCCGAGCTGC
GTGTCCGCAGAACCGTCTTTAGCC -> TGTCCGCAGAACCGTCTTTAGCCT
GTGTCTTAAACCCGTGTATTGACA -> TGTCTTAAACCCGTGTATTGACAC
GTGTGAACAGATGACTCGAGGCCC -> TGTGAACAGATGACTCGAGGCCCT
GTGTGCAGGGAAAGAAGTCTCACG -> TGTGCAGGGAAAGAAGTCTCACGT
GTGTGCGGGAGACTAAAAGAAGTC -> TGTGCGGGAGACTAAAAGAAGTCG
GTGTGGTATTCTCCAGAAGCTGGC -> TGTGGTATTCTCCAGAAGCTGGCT
GTGTGTATAAGACAGCTATCCTGA -> TGTGTATAAGACAGCTATCCTGAC
GTGTTTTTGATATTTGCATAGCTT -> TGTTTTTGATATTTGCATAGCTTT
GTTAAATTCCAGCACGGCCTCTGT -> TTAAATTCCAGCACGGCCTCTGTG
GTTACCTTGCCCCCCGGAGGTCGA -> TTACCTTGCCCCCCGGAGGTCGAT
GTTACGCGGCAACGACGGGGATGA -> TTACGCGGCAACGACGGGGATGAG
GTTAGGATCACTTGTGTAAGTCTA -> TTAGGATCACTTGTGTAAGTCTAC
GTTAGGCAACATTGGAGTTGCTCG -> TTAGGCAACATTGGAGTTGCTCGC
GTTAGTGTCCGCAGAACCGTCTTT -> TTAGTGTCCGCAGAACCGTCTTTA
GTTATCACGATGCACCAAGACTTG -> TTATCACGATGCACCAAGACTTGC
GTTCAACAAGAAGTGAAGCAGGTT -> TTCAACAAGAAGTGAAGCAGGTTC
GTTCCATAAACATCATTCTTATTT -> TTCCATAAACATCATTCTTATTTC
GTTCCCCAGGCCCTTCGTAGAACC -> TTCCCCAGGCCCTTCGTAGAACCA
GTTCCTGGTGGTGGTCTTTTGTCA -> TTCCTGGTGGTGGTCTTTTGTCAT
GTTCGTAACCTTCATAGGACTAGG -> TTCGTAACCTTCATAGGACTAGGA
GTTCTAAATCATATCACTAACCAC -> TTCTAAATCATATCACTAACCACC
GTTCTGCCGACTAATAACTTGTAC -> TTCTGCCGACTAATAACTTGTACA
GTTCTTACCGTTAGGATCACTTGT -> TTCTTACCGTTAGGATCACTTGTG
GTTGAATCTAGTCTTTCTTCAGTT -> TTGAATCTAGTCTTTCTTCAGTTC
GTTGCCGCGAAGTGGGGTAGGCCA -> TTGCCGCGAAGTGGGGTAGGCCAA
GTTGCTCGCTTATTCGAATAAGTG -> TTGCTCGCTTATTCGAATAAGTGG
GTTGCTTTCGTGTGGTATTCTCCA -> TTGCTTTCGTGTGGTATTCTCCAG
GTTGGTACGATTGCTAGCAACTAT -> TTGGTACGATTGCTAGCAACTATC
GTTGTCCAGGAAGATTGTGGAAGT -> TTGTCCAGGAAGATTGTGGAAGTA
GTTTTTGATATTTGCATAGCTTTT -> TTTTTGATATTTGCATAGCTTTTT
TAAAAACCACACCCCGCAATTCTA -> AAAAACCACACCCCGCAATTCTAC
TAAAACATCTTGTCCTGTTAAATT -> AAAACATCTTGTCCTGTTAAATTC
TAAAACGCCGGTTGTCCAGGAAGA -> AAAACGCCGGTTGTCCAGGAAGAT
TAAAAGAAGTCGAGGCCTTCGATA -> AAAAGAAGTCGAGGCCTTCGATAA
TAAAATATCAACTGGACCACGTCA -> AAAATATCAACTGGACCACGTCAC
TAAAATCCCTTAATAGAAAATTAA -> AAAATCCCTTAATAGAAAATTAAA
TAAAATCTCCTGGGAGCATCACGA -> AAAATCTCCTGGGAGCATCACGAC
TAAACATCATTCTTATTTCAGGCC -> AAACATCATTCTTATTTCAGGCCC
TAAACCACGCTATTTGTTCAACAA -> AAACCACGCTATTTGTTCAACAAG
TAAACCCGTGTATTGACACTCTGA -> AAACCCGTGTATTGACACTCTGAC
TAAACTCCATAAAAACCACACCCC -> AAACTCCATAAAAACCACACCCCG
TAAAGAAAGCTCTCTAAACCACGC -> AAAGAAAGCTCTCTAAACCACGCT
TAAATCATATCACTAACCACCGGA -> AAATCATATCACTAACCACCGGAC
TAAATTCCAGCACGGCCTCTGTGG -> AAATTCCAGCACGGCCTCTGTGGG
TAACATGACGTCGTGGAAGTTCTA -> AACATGACGTCGTGGAAGTTCTAA
TAACCACCGGACAAAGGTATGAGC -> AACCACCGGACAAAGGTATGAGCG
TAACCGGGGAACAAGGTGACTCCT -> AACCGGGGAACAAGGTGACTCCTT
TAACCTTCATAGGACTAGGACGCC -> AACCTTCATAGGACTAGGACGCCG
TAACGCGTCCGCAAATAGTAGGAT -> AACGCGTCCGCAAATAGTAGGATA
TAACGCTTGATATCTCTAGGTTAC -> AACGCTTGATATCTCTAGGTTACG
TAACGTATCCTTGGATACCCATGA -> AACGTATCCTTGGATACCCATGAT
TAACTAATGACCCTCGGGTTCCCC -> AACTAATGACCCTCGGGTTCCCCA
TAACTCGCTGCAGCAGTTCTTACC -> AACTCGCTGCAGCAGTTCTTACCG
TAACTTAGCAGCACACTGAGGTTA -> AACTTAGCAGCACACTGAGGTTAG
TAACTTGTACAAAACTTACGCACA -> AACTTGTACAAAACTTACGCACAG
TAAGACAGCTATCCTGACATTGAT -> AAGACAGCTATCCTGACATTGATT
TAAGACTGGACCTTCTATCGGCTG -> AAGACTGGACCTTCTATCGGCTGA
TAAGCTCCGCAAAAAGAGTGTATC -> AAGCTCCGCAAAAAGAGTGTATCA
TAAGTCTACTATCTGATCCGAGCT -> AAGTCTACTATCTGATCCGAGCTG
TAAGTGGACGGATCCATGCTGTCT -> AAGTGGACGGATCCATGCTGTCTT
TAAGTTGAATCTAGTCTTTCTTCA -> AAGTTGAATCTAGTCTTTCTTCAG
TAATAACTTGTACAAAACTTACGC -> AATAACTTGTACAAAACTTACGCA
TAATAGAAAATTAAAACATCTTGT -> AATAGAAAATTAAAACATCTTGTC
TAATAGACTATCCCGTGGTGTGTA -> AATAGACTATCCCGTGGTGTGTAT
TAATATCCGGTGTCCGACTGTGCC -> AATATCCGGTGTCCGACTGTGCCT
TAATCTCGCGGAGGTGCAAAGCTT -> AATCTCGCGGAGGTGCAAAGCTTA
TAATGACCCTCGGGTTCCCCAGGC -> AATGACCCTCGGGTTCCCCAGGCC
TACAAAACTTACGCACAGAACGGA -> ACAAAACTTACGCACAGAACGGAG
TACAAAGATATAAACTCCATAAAA -> ACAAAGATATAAACTCCATAAAAA
TACAATCCGGCTTATGACCATCAC -> ACAATCCGGCTTATGACCATCACT
TACACACATGACCATTGACTCATC -> ACACACATGACCATTGACTCATCG
TACACCAAGCGCACGAAGTCGTCA -> ACACCAAGCGCACGAAGTCGTCAT
TACACCCAGGTTATCACGATGCAC -> ACACCCAGGTTATCACGATGCACC
TACACCTTTGCTGCCGACTACTCT -> ACACCTTTGCTGCCGACTACTCTC
TACACGACATGTCCGAGAACTATG -> ACACGACATGTCCGAGAACTATGT
TACACGCGTCTTACTGGATTGAGA -> ACACGCGTCTTACTGGATTGAGAC
TACATCCCCCGCATATTACCTCTC -> ACATCCCCCGCATATTACCTCTCG
TACATTTATCCCAGTCCGATCCGA -> ACATTTATCCCAGTCCGATCCGAA
TACCACGTACCTTATTAAAATCCC -> ACCACGTACCTTATTAAAATCCCT
TACCAGTAGTCTAGTAATAGACTA -> ACCAGTAGTCTAGTAATAGACTAT
TACCCATGATACACGCGTCTTACT -> ACCCATGATACACGCGTCTTACTG
TACCGTTAGGATCACTTGTGTAAG -> ACCGTTAGGATCACTTGTGTAAGT
TACCTCTCGAGGCGAGATACCACG -> ACCTCTCGAGGCGAGATACCACGT
TACCTTATTAAAATCCCTTAATAG -> ACCTTATTAAAATCCCTTAATAGA
TACCTTGCCCCCCGGAGGTCGATC -> ACCTTGCCCCCCGGAGGTCGATCG
TACCTTTTTACACGACATGTCCGA -> ACCTTTTTACACGACATGTCCGAG
TACGAGTCTGCGAGGTGTGCAGGG -> ACGAGTCTGCGAGGTGTGCAGGGA
TACGATGCGCCAACTTAACGCTTG -> ACGATGCGCCAACTTAACGCTTGA
TACGATTGCTAGCAACTATCTTCA -> ACGATTGCTAGCAACTATCTTCAT
TACGCACAGAACGGAGTCCACACG -> ACGCACAGAACGGAGTCCACACGT
TACGCGGCAACGACGGGGATGAGT -> ACGCGGCAACGACGGGGATGAGTG
TACGCTCTGCGGGGGACATTGGAC -> ACGCTCTGCGGGGGACATTGGACA
TACGGAGCTAGCGTTCTGCCGACT -> ACGGAGCTAGCGTTCTGCCGACTA
TACGGCAGGCTCTTCCAATACGGA -> ACGGCAGGCTCTTCCAATACGGAG
TACTATCTGATCCGAGCTGGTAGG -> ACTATCTGATCCGAGCTGGTAGGT
TACTCTCATAGAAAAACAGGCTCA -> ACTCTCATAGAAAAACAGGCTCAT
TACTCTCTTAACTAATGACCCTCG -> ACTCTCTTAACTAATGACCCTCGG
TACTGGATTGAGACTCGACAAGCT -> ACTGGATTGAGACTCGACAAGCTC
TAGAAAAACAGGCTCATATGCCCA -> AGAAAAACAGGCTCATATGCCCAA
TAGAAAATTAAAACATCTTGTCCT -> AGAAAATTAAAACATCTTGTCCTG
TAGAACCACGCTTGTATAGACCGG -> AGAACCACGCTTGTATAGACCGGC
TAGACCGGCCGCACGTCACGGACC -> AGACCGGCCGCACGTCACGGACCC
TAGACTATCCCGTGGTGTGTATAA -> AGACTATCCCGTGGTGTGTATAAG
TAGATACACCTTTGCTGCCGACTA -> AGATACACCTTTGCTGCCGACTAC
TAGCAACTATCTTCATTACCAGTA -> AGCAACTATCTTCATTACCAGTAG
TAGCAGCACACTGAGGTTAGTGTC -> AGCAGCACACTGAGGTTAGTGTCC
TAGCCTAGTTAGGCAACATTGGAG -> AGCCTAGTTAGGCAACATTGGAGT
TAGCGTTCTGCCGACTAATAACTT -> AGCGTTCTGCCGACTAATAACTTG
TAGCTAAGTTGAATCTAGTCTTTC -> AGCTAAGTTGAATCTAGTCTTTCT
TAGCTACACACATGACCATTGACT -> AGCTACACACATGACCATTGACTC
TAGCTTATGTTGCCGCGAAGTGGG -> AGCTTATGTTGCCGCGAAGTGGGG
TAGCTTTTTCCGGTGGATCATTGA -> AGCTTTTTCCGGTGGATCATTGAT
TAGGACGCCGGAATTAGTGGCTGA -> AGGACGCCGGAATTAGTGGCTGAC
TAGGACTAGGACGCCGGAATTAGT -> AGGACTAGGACGCCGGAATTAGTG
TAGGATAGCTTATGTTGCCGCGAA -> AGGATAGCTTATGTTGCCGCGAAG
TAGGATATCATTGGGACTCACTAG -> AGGATATCATTGGGACTCACTAGT
TAGGATCACTTGTGTAAGTCTACT -> AGGATCACTTGTGTAAGTCTACTA
TAGGCAACATTGGAGTTGCTCGCT -> AGGCAACATTGGAGTTGCTCGCTT
TAGGCCAACGTCAATATCATTTTA -> AGGCCAACGTCAATATCATTTTAA
TAGGCCTCGTCTGCACCATGTCTT -> AGGCCTCGTCTGCACCATGTCTTT
TAGGGTCTGCGGTGGATAGGATAT -> AGGGTCTGCGGTGGATAGGATATC
TAGGTAGATACACCTTTGCTGCCG -> AGGTAGATACACCTTTGCTGCCGA
TAGGTTACGCGGCAACGACGGGGA -> AGGTTACGCGGCAACGACGGGGAT
TAGTAATAGACTATCCCGTGGTGT -> AGTAATAGACTATCCCGTGGTGTG
TAGTAGGATAGCTTATGTTGCCGC -> AGTAGGATAGCTTATGTTGCCGCG
TAGTCGTATCAAGTCAACACCATC -> AGTCGTATCAAGTCAACACCATCG
TAGTCTAGTAATAGACTATCCCGT -> AGTCTAGTAATAGACTATCCCGTG
TAGTCTTTCTTCAGTTCGTAACCT -> AGTCTTTCTTCAGTTCGTAACCTT
TAGTGGCTGACGAGTGTCTTAAAC -> AGTGGCTGACGAGTGTCTTAAACC
TAGTGTCCGCAGAACCGTCTTTAG -> AGTGTCCGCAGAACCGTCTTTAGC
TAGTGTTTTTGATATTTGCATAGC -> AGTGTTTTTGATATTTGCATAGCT
TAGTTAGGCAACATTGGAGTTGCT -> AGTTAGGCAACATTGGAGTTGCTC
TATAAACTCCATAAAAACCACACC -> ATAAACTCCATAAAAACCACACCC
TATAACTTAGCAGCACACTGAGGT -> ATAACTTAGCAGCACACTGAGGTT
TATAAGACAGCTATCCTGACATTG -> ATAAGACAGCTATCCTGACATTGA
TATAGACCGGCCGCACGTCACGGA -> ATAGACCGGCCGCACGTCACGGAC
TATCAACTGGACCACGTCACCGGT -> ATCAACTGGACCACGTCACCGGTG
TATCAAGTCAACACCATCGGGGTA -> ATCAAGTCAACACCATCGGGGTAG
TATCACGATGCACCAAGACTTGCC -> ATCACGATGCACCAAGACTTGCCT
TATCACTAACCACCGGACAAAGGT -> ATCACTAACCACCGGACAAAGGTA
TATCATCGAACAGTCACATGCGAT -> ATCATCGAACAGTCACATGCGATA
TATCATTGGGACTCACTAGTCGTA -> ATCATTGGGACTCACTAGTCGTAT
TATCATTTTAACTCGCTGCAGCAG -> ATCATTTTAACTCGCTGCAGCAGT
TATCCAGGGCCACACAGTCTATCC -> ATCCAGGGCCACACAGTCTATCCG
TATCCCAGTCCGATCCGAATCTAT -> ATCCCAGTCCGATCCGAATCTATT
TATCCCGTGGTGTGTATAAGACAG -> ATCCCGTGGTGTGTATAAGACAGC
TATCCGACACCATACAAAGATATA -> ATCCGACACCATACAAAGATATAA
TATCCGGTGTCCGACTGTGCCTCC -> ATCCGGTGTCCGACTGTGCCTCCG
TATCCTGACATTGATTGGCAAGTA -> ATCCTGACATTGATTGGCAAGTAA
TATCCTTGGATACCCATGATACAC -> ATCCTTGGATACCCATGATACACG
TATCGCAAAACCCCTGACCTAAGA -> ATCGCAAAACCCCTGACCTAAGAC
TATCGGCTGAACTTTACGCTCTGC -> ATCGGCTGAACTTTACGCTCTGCG
TATCTAGTGTTTTTGATATTTGCA -> ATCTAGTGTTTTTGATATTTGCAT
TATCTCTAGGTTACGCGGCAACGA -> ATCTCTAGGTTACGCGGCAACGAC
TATCTGATCCGAGCTGGTAGGTAG -> ATCTGATCCGAGCTGGTAGGTAGA
TATCTTCATTACCAGTAGTCTAGT -> ATCTTCATTACCAGTAGTCTAGTA
TATGACCATCACTCCAAGCCCCCG -> ATGACCATCACTCCAAGCCCCCGC
TATGAGCGTTCCTGGTGGTGGTCT -> ATGAGCGTTCCTGGTGGTGGTCTT
TATGCCCAACTGGTCAGCGGATCG -> ATGCCCAACTGGTCAGCGGATCGA
TATGTCGTGTCCAGCTCAGAGTAC -> ATGTCGTGTCCAGCTCAGAGTACA
TATGTTGCCGCGAAGTGGGGTAGG -> ATGTTGCCGCGAAGTGGGGTAGGC
TATTAAAATCCCTTAATAGAAAAT -> ATTAAAATCCCTTAATAGAAAATT
TATTACCTCTCGAGGCGAGATACC -> ATTACCTCTCGAGGCGAGATACCA
TATTCCCGCCGTCCTTGATTCACC -> ATTCCCGCCGTCCTTGATTCACCA
TATTCGAATAAGTGGACGGATCCA -> ATTCGAATAAGTGGACGGATCCAT
TATTCTCCAGAAGCTGGCTCAGAA -> ATTCTCCAGAAGCTGGCTCAGAAT
TATTGACACTCTGACACTTAAAAC -> ATTGACACTCTGACACTTAAAACG
TATTGTACCTTTTTACACGACATG -> ATTGTACCTTTTTACACGACATGT
TATTTCAGGCCCCAGACTATAACT -> ATTTCAGGCCCCAGACTATAACTT
TATTTCTTCTGGAACGCCATTATT -> ATTTCTTCTGGAACGCCATTATTT
TATTTGCATAGCTTTTTCCGGTGG -> ATTTGCATAGCTTTTTCCGGTGGA
TATTTGTTCAACAAGAAGTGAAGC -> ATTTGTTCAACAAGAAGTGAAGCA
TATTTTTAGGCCTCGTCTGCACCA -> ATTTTTAGGCCTCGTCTGCACCAT
TCAACAAGAAGTGAAGCAGGTTCC -> CAACAAGAAGTGAAGCAGGTTCCA
TCAACACCATCGGGGTAGCTACAC -> CAACACCATCGGGGTAGCTACACA
TCAACTGGACCACGTCACCGGTGC -> CAACTGGACCACGTCACCGGTGCT
TCAAGTCAACACCATCGGGGTAGC -> CAAGTCAACACCATCGGGGTAGCT
TCAATATCATTTTAACTCGCTGCA -> CAATATCATTTTAACTCGCTGCAG
TCACAATCCGTGTGAACAGATGAC -> CACAATCCGTGTGAACAGATGACT
TCACATGCGATATTCCCGCCGTCC -> CACATGCGATATTCCCGCCGTCCT
TCACCATTGGGCACTGTCCCCGCT -> CACCATTGGGCACTGTCCCCGCTA
TCACCGGTGCTTGACGGTTACCTT -> CACCGGTGCTTGACGGTTACCTTG
TCACCTACATTTATCCCAGTCCGA -> CACCTACATTTATCCCAGTCCGAT
TCACGACACTGAACGCATGTAACG -> CACGACACTGAACGCATGTAACGT
TCACGATGCACCAAGACTTGCCTC -> CACGATGCACCAAGACTTGCCTCA
TCACGGACCCAATACAATCCGGCT -> CACGGACCCAATACAATCCGGCTT
TCACGTGACCCCAGGGACCTTACG -> CACGTGACCCCAGGGACCTTACGG
TCACTAACCACCGGACAAAGGTAT -> CACTAACCACCGGACAAAGGTATG
TCACTAACGCGTCCGCAAATAGTA -> CACTAACGCGTCCGCAAATAGTAG
TCACTAGTCGTATCAAGTCAACAC -> CACTAGTCGTATCAAGTCAACACC
TCACTCCAAGCCCCCGCATTTCGG -> CACTCCAAGCCCCCGCATTTCGGA
TCACTTGTGTAAGTCTACTATCTG -> CACTTGTGTAAGTCTACTATCTGA
TCAGAATCTGCTACATCCCCCGCA -> CAGAATCTGCTACATCCCCCGCAT
TCAGAGTACACCAAGCGCACGAAG -> CAGAGTACACCAAGCGCACGAAGT
TCAGCGGATCGATTAATCTCGCGG -> CAGCGGATCGATTAATCTCGCGGA
TCAGGCCCCAGACTATAACTTAGC -> CAGGCCCCAGACTATAACTTAGCA
TCAGTTCGTAACCTTCATAGGACT -> CAGTTCGTAACCTTCATAGGACTA
TCATAGAAAAACAGGCTCATATGC -> CATAGAAAAACAGGCTCATATGCC
TCATAGGACTAGGACGCCGGAATT -> CATAGGACTAGGACGCCGGAATTA
TCATATCACTAACCACCGGACAAA -> CATATCACTAACCACCGGACAAAG
TCATATGCCCAACTGGTCAGCGGA -> CATATGCCCAACTGGTCAGCGGAT
TCATCCCGTCGTGAACTATCGCAA -> CATCCCGTCGTGAACTATCGCAAA
TCATCGAACAGTCACATGCGATAT -> CATCGAACAGTCACATGCGATATT
TCATCGCTCGATAACCGGGGAACA -> CATCGCTCGATAACCGGGGAACAA
TCATCTCCCTTGGACAACATCGGG -> CATCTCCCTTGGACAACATCGGGT
TCATGGTTGCTTTCGTGTGGTATT -> CATGGTTGCTTTCGTGTGGTATTC
TCATTACCAGTAGTCTAGTAATAG -> CATTACCAGTAGTCTAGTAATAGA
TCATTCTTATTTCAGGCCCCAGAC -> CATTCTTATTTCAGGCCCCAGACT
TCATTGATGCCAGGCAAACTGGCC -> CATTGATGCCAGGCAAACTGGCCT
TCATTGGGACTCACTAGTCGTATC -> CATTGGGACTCACTAGTCGTATCA
TCATTTTAACTCGCTGCAGCAGTT -> CATTTTAACTCGCTGCAGCAGTTC
TCCAATACGGAGCTAGCGTTCTGC -> CCAATACGGAGCTAGCGTTCTGCC
TCCACACGTGCCCAATCGCGATAC -> CCACACGTGCCCAATCGCGATACA
TCCAGAAGCTGGCTCAGAATCTGC -> CCAGAAGCTGGCTCAGAATCTGCT
TCCAGCACGGCCTCTGTGGGGCAT -> CCAGCACGGCCTCTGTGGGGCATG
TCCAGCTCAGAGTACACCAAGCGC -> CCAGCTCAGAGTACACCAAGCGCA
TCCAGGAAGATTGTGGAAGTAAAG -> CCAGGAAGATTGTGGAAGTAAAGA
TCCAGGGCCACACAGTCTATCCGA -> CCAGGGCCACACAGTCTATCCGAC
TCCATAAAAACCACACCCCGCAAT -> CCATAAAAACCACACCCCGCAATT
TCCATAAACATCATTCTTATTTCA -> CCATAAACATCATTCTTATTTCAG
TCCATGCTGTCTTGATTATCCAGG -> CCATGCTGTCTTGATTATCCAGGG
TCCCAGTCCGATCCGAATCTATTG -> CCCAGTCCGATCCGAATCTATTGT
TCCCCAGGCCCTTCGTAGAACCAC -> CCCCAGGCCCTTCGTAGAACCACG
TCCCCCGCATATTACCTCTCGAGG -> CCCCCGCATATTACCTCTCGAGGC
TCCCCGCTATCTAGTGTTTTTGAT -> CCCCGCTATCTAGTGTTTTTGATA
TCCCGCCGTCCTTGATTCACCATT -> CCCGCCGTCCTTGATTCACCATTG
TCCCGTCGTGAACTATCGCAAAAC -> CCCGTCGTGAACTATCGCAAAACC
TCCCGTGGTGTGTATAAGACAGCT -> CCCGTGGTGTGTATAAGACAGCTA
TCCCTTAATAGAAAATTAAAACAT -> CCCTTAATAGAAAATTAAAACATC
TCCCTTGGACAACATCGGGTTGGT -> CCCTTGGACAACATCGGGTTGGTA
TCCGAATCTATTGTACCTTTTTAC -> CCGAATCTATTGTACCTTTTTACA
TCCGACACCATACAAAGATATAAA -> CCGACACCATACAAAGATATAAAC
TCCGACTGTGCCTCCGAGCTGCGG -> CCGACTGTGCCTCCGAGCTGCGGA
TCCGAGAACTATGTCGTGTCCAGC -> CCGAGAACTATGTCGTGTCCAGCT
TCCGAGCTGCGGACGATTAAGCTC -> CCGAGCTGCGGACGATTAAGCTCC
TCCGAGCTGGTAGGTAGATACACC -> CCGAGCTGGTAGGTAGATACACCT
TCCGATCCGAATCTATTGTACCTT -> CCGATCCGAATCTATTGTACCTTT
TCCGCAAAAAGAGTGTATCATCGA -> CCGCAAAAAGAGTGTATCATCGAA
TCCGCAAATAGTAGGATAGCTTAT -> CCGCAAATAGTAGGATAGCTTATG
TCCGCAGAACCGTCTTTAGCCTAG -> CCGCAGAACCGTCTTTAGCCTAGT
TCCGGCTTATGACCATCACTCCAA -> CCGGCTTATGACCATCACTCCAAG
TCCGGTGGATCATTGATGCCAGGC -> CCGGTGGATCATTGATGCCAGGCA
TCCGGTGTCCGACTGTGCCTCCGA -> CCGGTGTCCGACTGTGCCTCCGAG
TCCGTGTGAACAGATGACTCGAGG -> CCGTGTGAACAGATGACTCGAGGC
TCCTGACATTGATTGGCAAGTAAA -> CCTGACATTGATTGGCAAGTAAAA
TCCTGGGAGCATCACGACACTGAA -> CCTGGGAGCATCACGACACTGAAC
TCCTGGTGGTGGTCTTTTGTCATC -> CCTGGTGGTGGTCTTTTGTCATCT
TCCTGTTAAATTCCAGCACGGCCT -> CCTGTTAAATTCCAGCACGGCCTC
TCCTTCATGGTTGCTTTCGTGTGG -> CCTTCATGGTTGCTTTCGTGTGGT
TCCTTGATTCACCATTGGGCACTG -> CCTTGATTCACCATTGGGCACTGT
TCCTTGGATACCCATGATACACGC -> CCTTGGATACCCATGATACACGCG
TCGAACAGTCACATGCGATATTCC -> CGAACAGTCACATGCGATATTCCC
TCGAATAAGTGGACGGATCCATGC -> CGAATAAGTGGACGGATCCATGCT
TCGACAAGCTCTTGGAGAACCTCA -> CGACAAGCTCTTGGAGAACCTCAC
TCGAGGCCCTTCGCTAGCTAAGTT -> CGAGGCCCTTCGCTAGCTAAGTTG
TCGAGGCCTTCGATAAAATATCAA -> CGAGGCCTTCGATAAAATATCAAC
TCGAGGCGAGATACCACGTACCTT -> CGAGGCGAGATACCACGTACCTTA
TCGATAAAATATCAACTGGACCAC -> CGATAAAATATCAACTGGACCACG
TCGATAACCGGGGAACAAGGTGAC -> CGATAACCGGGGAACAAGGTGACT
TCGATCGGAGTGGAGGGAGTAGGG -> CGATCGGAGTGGAGGGAGTAGGGT
TCGATTAATCTCGCGGAGGTGCAA -> CGATTAATCTCGCGGAGGTGCAAA
TCGCAAAACCCCTGACCTAAGACT -> CGCAAAACCCCTGACCTAAGACTG
TCGCGATACACCCAGGTTATCACG -> CGCGATACACCCAGGTTATCACGA
TCGCGGAGGTGCAAAGCTTATTTC -> CGCGGAGGTGCAAAGCTTATTTCT
TCGCTAGCTAAGTTGAATCTAGTC -> CGCTAGCTAAGTTGAATCTAGTCT
TCGCTCGATAACCGGGGAACAAGG -> CGCTCGATAACCGGGGAACAAGGT
TCGCTGCAGCAGTTCTTACCGTTA -> CGCTGCAGCAGTTCTTACCGTTAG
TCGCTTATTCGAATAAGTGGACGG -> CGCTTATTCGAATAAGTGGACGGA
TCGGAGTGGAGGGAGTAGGGTCTG -> CGGAGTGGAGGGAGTAGGGTCTGC
TCGGCTGAACTTTACGCTCTGCGG -> CGGCTGAACTTTACGCTCTGCGGG
TCGGGGTAGCTACACACATGACCA -> CGGGGTAGCTACACACATGACCAT
TCGGGTTCCCCAGGCCCTTCGTAG -> CGGGTTCCCCAGGCCCTTCGTAGA
TCGGGTTGGTACGATTGCTAGCAA -> CGGGTTGGTACGATTGCTAGCAAC
TCGTAACCTTCATAGGACTAGGAC -> CGTAACCTTCATAGGACTAGGACG
TCGTAGAACCACGCTTGTATAGAC -> CGTAGAACCACGCTTGTATAGACC
TCGTATCAAGTCAACACCATCGGG -> CGTATCAAGTCAACACCATCGGGG
TCGTCATCCCGTCGTGAACTATCG -> CGTCATCCCGTCGTGAACTATCGC
TCGTCTGCACCATGTCTTTACGAT -> CGTCTGCACCATGTCTTTACGATG
TCGTGAACTATCGCAAAACCCCTG -> CGTGAACTATCGCAAAACCCCTGA
TCGTGGAAGTTCTAAATCATATCA -> CGTGGAAGTTCTAAATCATATCAC
TCGTGTCCAGCTCAGAGTACACCA -> CGTGTCCAGCTCAGAGTACACCAA
TCGTGTGGTATTCTCCAGAAGCTG -> CGTGTGGTATTCTCCAGAAGCTGG
TCTAAACCACGCTATTTGTTCAAC -> CTAAACCACGCTATTTGTTCAACA
TCTAAATCATATCACTAACCACCG -> CTAAATCATATCACTAACCACCGG
TCTACTATCTGATCCGAGCTGGTA -> CTACTATCTGATCCGAGCTGGTAG
TCTACTCTCATAGAAAAACAGGCT -> CTACTCTCATAGAAAAACAGGCTC
TCTAGGTTACGCGGCAACGACGGG -> CTAGGTTACGCGGCAACGACGGGG
TCTAGTAATAGACTATCCCGTGGT -> CTAGTAATAGACTATCCCGTGGTG
TCTAGTCTTTCTTCAGTTCGTAAC -> CTAGTCTTTCTTCAGTTCGTAACC
TCTAGTGTTTTTGATATTTGCATA -> CTAGTGTTTTTGATATTTGCATAG
TCTATCCGACACCATACAAAGATA -> CTATCCGACACCATACAAAGATAT
TCTATCGGCTGAACTTTACGCTCT -> CTATCGGCTGAACTTTACGCTCTG
TCTATTGTACCTTTTTACACGACA -> CTATTGTACCTTTTTACACGACAT
TCTCACGTGACCCCAGGGACCTTA -> CTCACGTGACCCCAGGGACCTTAC
TCTCATAGAAAAACAGGCTCATAT -> CTCATAGAAAAACAGGCTCATATG
TCTCCAGAAGCTGGCTCAGAATCT -> CTCCAGAAGCTGGCTCAGAATCTG
TCTCCCTTGGACAACATCGGGTTG -> CTCCCTTGGACAACATCGGGTTGG
TCTCCTGGGAGCATCACGACACTG -> CTCCTGGGAGCATCACGACACTGA
TCTCGAGGCGAGATACCACGTACC -> CTCGAGGCGAGATACCACGTACCT
TCTCGCGGAGGTGCAAAGCTTATT -> CTCGCGGAGGTGCAAAGCTTATTT
TCTCTAAACCACGCTATTTGTTCA -> CTCTAAACCACGCTATTTGTTCAA
TCTCTAGGTTACGCGGCAACGACG -> CTCTAGGTTACGCGGCAACGACGG
TCTCTTAACTAATGACCCTCGGGT -> CTCTTAACTAATGACCCTCGGGTT
TCTGACACTTAAAACGCCGGTTGT -> CTGACACTTAAAACGCCGGTTGTC
TCTGATCCGAGCTGGTAGGTAGAT -> CTGATCCGAGCTGGTAGGTAGATA
TCTGCACCATGTCTTTACGATGCG -> CTGCACCATGTCTTTACGATGCGC
TCTGCCGACTAATAACTTGTACAA -> CTGCCGACTAATAACTTGTACAAA
TCTGCGAGGTGTGCAGGGAAAGAA -> CTGCGAGGTGTGCAGGGAAAGAAG
TCTGCGGGGGACATTGGACACACG -> CTGCGGGGGACATTGGACACACGA
TCTGCGGTGGATAGGATATCATTG -> CTGCGGTGGATAGGATATCATTGG
TCTGCTACATCCCCCGCATATTAC -> CTGCTACATCCCCCGCATATTACC
TCTGGAACGCCATTATTTTTAGGC -> CTGGAACGCCATTATTTTTAGGCC
TCTGTGGGGCATGTGCTGAGATAC -> CTGTGGGGCATGTGCTGAGATACG
TCTTAAACCCGTGTATTGACACTC -> CTTAAACCCGTGTATTGACACTCT
TCTTAACTAATGACCCTCGGGTTC -> CTTAACTAATGACCCTCGGGTTCC
TCTTACCGTTAGGATCACTTGTGT -> CTTACCGTTAGGATCACTTGTGTA
TCTTACTGGATTGAGACTCGACAA -> CTTACTGGATTGAGACTCGACAAG
TCTTATTTCAGGCCCCAGACTATA -> CTTATTTCAGGCCCCAGACTATAA
TCTTCAGTTCGTAACCTTCATAGG -> CTTCAGTTCGTAACCTTCATAGGA
TCTTCATTACCAGTAGTCTAGTAA -> CTTCATTACCAGTAGTCTAGTAAT
TCTTCCAATACGGAGCTAGCGTTC -> CTTCCAATACGGAGCTAGCGTTCT
TCTTCTGGAACGCCATTATTTTTA -> CTTCTGGAACGCCATTATTTTTAG
TCTTGATTATCCAGGGCCACACAG -> CTTGATTATCCAGGGCCACACAGT
TCTTGGAGAACCTCACTAACGCGT -> CTTGGAGAACCTCACTAACGCGTC
TCTTGTCCTGTTAAATTCCAGCAC -> CTTGTCCTGTTAAATTCCAGCACG
TCTTTACGATGCGCCAACTTAACG -> CTTTACGATGCGCCAACTTAACGC
TCTTTAGCCTAGTTAGGCAACATT -> CTTTAGCCTAGTTAGGCAACATTG
TCTTTCTTCAGTTCGTAACCTTCA -> CTTTCTTCAGTTCGTAACCTTCAT
TCTTTTGTCATCTCCCTTGGACAA -> CTTTTGTCATCTCCCTTGGACAAC
TGAACAGATGACTCGAGGCCCTTC -> GAACAGATGACTCGAGGCCCTTCG
TGAACGCATGTAACGTATCCTTGG -> GAACGCATGTAACGTATCCTTGGA
TGAACTATCGCAAAACCCCTGACC -> GAACTATCGCAAAACCCCTGACCT
TGAACTTTACGCTCTGCGGGGGAC -> GAACTTTACGCTCTGCGGGGGACA
TGAAGCAGGTTCCATAAACATCAT -> GAAGCAGGTTCCATAAACATCATT
TGAATCTAGTCTTTCTTCAGTTCG -> GAATCTAGTCTTTCTTCAGTTCGT
TGACACTCTGACACTTAAAACGCC -> GACACTCTGACACTTAAAACGCCG
TGACACTTAAAACGCCGGTTGTCC -> GACACTTAAAACGCCGGTTGTCCA
TGACATTGATTGGCAAGTAAAATC -> GACATTGATTGGCAAGTAAAATCT
TGACCATCACTCCAAGCCCCCGCA -> GACCATCACTCCAAGCCCCCGCAT
TGACCATTGACTCATCGCTCGATA -> GACCATTGACTCATCGCTCGATAA
TGACCCCAGGGACCTTACGGCAGG -> GACCCCAGGGACCTTACGGCAGGC
TGACCCTCGGGTTCCCCAGGCCCT -> GACCCTCGGGTTCCCCAGGCCCTT
TGACCTAAGACTGGACCTTCTATC -> GACCTAAGACTGGACCTTCTATCG
TGACGAGTGTCTTAAACCCGTGTA -> GACGAGTGTCTTAAACCCGTGTAT
TGACGGTTACCTTGCCCCCCGGAG -> GACGGTTACCTTGCCCCCCGGAGG
TGACGTCGTGGAAGTTCTAAATCA -> GACGTCGTGGAAGTTCTAAATCAT
TGACTCATCGCTCGATAACCGGGG -> GACTCATCGCTCGATAACCGGGGA
TGACTCCTTCATGGTTGCTTTCGT -> GACTCCTTCATGGTTGCTTTCGTG
TGACTCGAGGCCCTTCGCTAGCTA -> GACTCGAGGCCCTTCGCTAGCTAA
TGAGACTCGACAAGCTCTTGGAGA -> GAGACTCGACAAGCTCTTGGAGAA
TGAGATACGAGTCTGCGAGGTGTG -> GAGATACGAGTCTGCGAGGTGTGC
TGAGCGTTCCTGGTGGTGGTCTTT -> GAGCGTTCCTGGTGGTGGTCTTTT
TGAGGTTAGTGTCCGCAGAACCGT -> GAGGTTAGTGTCCGCAGAACCGTC
TGAGTGCGACCCTTGTAATATCCG -> GAGTGCGACCCTTGTAATATCCGG
TGATACACGCGTCTTACTGGATTG -> GATACACGCGTCTTACTGGATTGA
TGATATCTCTAGGTTACGCGGCAA -> GATATCTCTAGGTTACGCGGCAAC
TGATATTTGCATAGCTTTTTCCGG -> GATATTTGCATAGCTTTTTCCGGT
TGATCCGAGCTGGTAGGTAGATAC -> GATCCGAGCTGGTAGGTAGATACA
TGATGCCAGGCAAACTGGCCTTAA -> GATGCCAGGCAAACTGGCCTTAAC
TGATTATCCAGGGCCACACAGTCT -> GATTATCCAGGGCCACACAGTCTA
TGATTCACCATTGGGCACTGTCCC -> GATTCACCATTGGGCACTGTCCCC
TGATTGGCAAGTAAAATCTCCTGG -> GATTGGCAAGTAAAATCTCCTGGG
TGCAAAGCTTATTTCTTCTGGAAC -> GCAAAGCTTATTTCTTCTGGAACG
TGCACCAAGACTTGCCTCACAATC -> GCACCAAGACTTGCCTCACAATCC
TGCACCATGTCTTTACGATGCGCC -> GCACCATGTCTTTACGATGCGCCA
TGCAGCAGTTCTTACCGTTAGGAT -> GCAGCAGTTCTTACCGTTAGGATC
TGCAGGGAAAGAAGTCTCACGTGA -> GCAGGGAAAGAAGTCTCACGTGAC
TGCATAGCTTTTTCCGGTGGATCA -> GCATAGCTTTTTCCGGTGGATCAT
TGCCAGGCAAACTGGCCTTAACAT -> GCCAGGCAAACTGGCCTTAACATG
TGCCCAACTGGTCAGCGGATCGAT -> GCCCAACTGGTCAGCGGATCGATT
TGCCCAATCGCGATACACCCAGGT -> GCCCAATCGCGATACACCCAGGTT
TGCCCCCCGGAGGTCGATCGGAGT -> GCCCCCCGGAGGTCGATCGGAGTG
TGCCGACTAATAACTTGTACAAAA -> GCCGACTAATAACTTGTACAAAAC
TGCCGACTACTCTCTTAACTAATG -> GCCGACTACTCTCTTAACTAATGA
TGCCGCGAAGTGGGGTAGGCCAAC -> GCCGCGAAGTGGGGTAGGCCAACG
TGCCTCACAATCCGTGTGAACAGA -> GCCTCACAATCCGTGTGAACAGAT
TGCCTCCGAGCTGCGGACGATTAA -> GCCTCCGAGCTGCGGACGATTAAG
TGCGACCCTTGTAATATCCGGTGT -> GCGACCCTTGTAATATCCGGTGTC
TGCGAGGTGTGCAGGGAAAGAAGT -> GCGAGGTGTGCAGGGAAAGAAGTC
TGCGATATTCCCGCCGTCCTTGAT -> GCGATATTCCCGCCGTCCTTGATT
TGCGCCAACTTAACGCTTGATATC -> GCGCCAACTTAACGCTTGATATCT
TGCGGACGATTAAGCTCCGCAAAA -> GCGGACGATTAAGCTCCGCAAAAA
TGCGGGAGACTAAAAGAAGTCGAG -> GCGGGAGACTAAAAGAAGTCGAGG
TGCGGGGGACATTGGACACACGAG -> GCGGGGGACATTGGACACACGAGC
TGCGGTGGATAGGATATCATTGGG -> GCGGTGGATAGGATATCATTGGGA
TGCTACATCCCCCGCATATTACCT -> GCTACATCCCCCGCATATTACCTC
TGCTAGCAACTATCTTCATTACCA -> GCTAGCAACTATCTTCATTACCAG
TGCTCGCTTATTCGAATAAGTGGA -> GCTCGCTTATTCGAATAAGTGGAC
TGCTGAGATACGAGTCTGCGAGGT -> GCTGAGATACGAGTCTGCGAGGTG
TGCTGCCGACTACTCTCTTAACTA -> GCTGCCGACTACTCTCTTAACTAA
TGCTGTCTTGATTATCCAGGGCCA -> GCTGTCTTGATTATCCAGGGCCAC
TGCTTGACGGTTACCTTGCCCCCC -> GCTTGACGGTTACCTTGCCCCCCG
TGCTTTCGTGTGGTATTCTCCAGA -> GCTTTCGTGTGGTATTCTCCAGAA
TGGAACGCCATTATTTTTAGGCCT -> GGAACGCCATTATTTTTAGGCCTC
TGGAAGTAAAGAAAGCTCTCTAAA -> GGAAGTAAAGAAAGCTCTCTAAAC
TGGAAGTTCTAAATCATATCACTA -> GGAAGTTCTAAATCATATCACTAA
TGGACAACATCGGGTTGGTACGAT -> GGACAACATCGGGTTGGTACGATT
TGGACACACGAGCGGTGTGCGGGA -> GGACACACGAGCGGTGTGCGGGAG
TGGACCACGTCACCGGTGCTTGAC -> GGACCACGTCACCGGTGCTTGACG
TGGACCTTCTATCGGCTGAACTTT -> GGACCTTCTATCGGCTGAACTTTA
TGGACGGATCCATGCTGTCTTGAT -> GGACGGATCCATGCTGTCTTGATT
TGGAGAACCTCACTAACGCGTCCG -> GGAGAACCTCACTAACGCGTCCGC
TGGAGGGAGTAGGGTCTGCGGTGG -> GGAGGGAGTAGGGTCTGCGGTGGA
TGGAGTTGCTCGCTTATTCGAATA -> GGAGTTGCTCGCTTATTCGAATAA
TGGATACCCATGATACACGCGTCT -> GGATACCCATGATACACGCGTCTT
TGGATAGGATATCATTGGGACTCA -> GGATAGGATATCATTGGGACTCAC
TGGATCATTGATGCCAGGCAAACT -> GGATCATTGATGCCAGGCAAACTG
TGGATTGAGACTCGACAAGCTCTT -> GGATTGAGACTCGACAAGCTCTTG
TGGCAAGTAAAATCTCCTGGGAGC -> GGCAAGTAAAATCTCCTGGGAGCA
TGGCCTTAACATGACGTCGTGGAA -> GGCCTTAACATGACGTCGTGGAAG
TGGCTCAGAATCTGCTACATCCCC -> GGCTCAGAATCTGCTACATCCCCC
TGGCTGACGAGTGTCTTAAACCCG -> GGCTGACGAGTGTCTTAAACCCGT
TGGGACTCACTAGTCGTATCAAGT -> GGGACTCACTAGTCGTATCAAGTC
TGGGAGCATCACGACACTGAACGC -> GGGAGCATCACGACACTGAACGCA
TGGGCACTGTCCCCGCTATCTAGT -> GGGCACTGTCCCCGCTATCTAGTG
TGGGGCATGTGCTGAGATACGAGT -> GGGGCATGTGCTGAGATACGAGTC
TGGGGTAGGCCAACGTCAATATCA -> GGGGTAGGCCAACGTCAATATCAT
TGGTACGATTGCTAGCAACTATCT -> GGTACGATTGCTAGCAACTATCTT
TGGTAGGTAGATACACCTTTGCTG -> GGTAGGTAGATACACCTTTGCTGC
TGGTATTCTCCAGAAGCTGGCTCA -> GGTATTCTCCAGAAGCTGGCTCAG
TGGTCAGCGGATCGATTAATCTCG -> GGTCAGCGGATCGATTAATCTCGC
TGGTCTTTTGTCATCTCCCTTGGA -> GGTCTTTTGTCATCTCCCTTGGAC
TGGTGGTCTTTTGTCATCTCCCTT -> GGTGGTCTTTTGTCATCTCCCTTG
TGGTGGTGGTCTTTTGTCATCTCC -> GGTGGTGGTCTTTTGTCATCTCCC
TGGTGTGTATAAGACAGCTATCCT -> GGTGTGTATAAGACAGCTATCCTG
TGGTTGCTTTCGTGTGGTATTCTC -> GGTTGCTTTCGTGTGGTATTCTCC
TGTAACGTATCCTTGGATACCCAT -> GTAACGTATCCTTGGATACCCATG
TGTAAGTCTACTATCTGATCCGAG -> GTAAGTCTACTATCTGATCCGAGC
TGTAATATCCGGTGTCCGACTGTG -> GTAATATCCGGTGTCCGACTGTGC
TGTACAAAACTTACGCACAGAACG -> GTACAAAACTTACGCACAGAACGG
TGTACCTTTTTACACGACATGTCC -> GTACCTTTTTACACGACATGTCCG
TGTATAAGACAGCTATCCTGACAT -> GTATAAGACAGCTATCCTGACATT
TGTATAGACCGGCCGCACGTCACG -> GTATAGACCGGCCGCACGTCACGG
TGTATCATCGAACAGTCACATGCG -> GTATCATCGAACAGTCACATGCGA
TGTATTGACACTCTGACACTTAAA -> GTATTGACACTCTGACACTTAAAA
TGTCATCTCCCTTGGACAACATCG -> GTCATCTCCCTTGGACAACATCGG
TGTCCAGCTCAGAGTACACCAAGC -> GTCCAGCTCAGAGTACACCAAGCG
TGTCCAGGAAGATTGTGGAAGTAA -> GTCCAGGAAGATTGTGGAAGTAAA
TGTCCCCGCTATCTAGTGTTTTTG -> GTCCCCGCTATCTAGTGTTTTTGA
TGTCCGACTGTGCCTCCGAGCTGC -> GTCCGACTGTGCCTCCGAGCTGCG
TGTCCGAGAACTATGTCGTGTCCA -> GTCCGAGAACTATGTCGTGTCCAG
TGTCCGCAGAACCGTCTTTAGCCT -> GTCCGCAGAACCGTCTTTAGCCTA
TGTCCTGTTAAATTCCAGCACGGC -> GTCCTGTTAAATTCCAGCACGGCC
TGTCGTGTCCAGCTCAGAGTACAC -> GTCGTGTCCAGCTCAGAGTACACC
TGTCTTAAACCCGTGTATTGACAC -> GTCTTAAACCCGTGTATTGACACT
TGTCTTGATTATCCAGGGCCACAC -> GTCTTGATTATCCAGGGCCACACA
TGTCTTTACGATGCGCCAACTTAA -> GTCTTTACGATGCGCCAACTTAAC
TGTGAACAGATGACTCGAGGCCCT -> GTGAACAGATGACTCGAGGCCCTT
TGTGCAGGGAAAGAAGTCTCACGT -> GTGCAGGGAAAGAAGTCTCACGTG
TGTGCCTCCGAGCTGCGGACGATT -> GTGCCTCCGAGCTGCGGACGATTA
TGTGCGGGAGACTAAAAGAAGTCG -> GTGCGGGAGACTAAAAGAAGTCGA
TGTGCTGAGATACGAGTCTGCGAG -> GTGCTGAGATACGAGTCTGCGAGG
TGTGGAAGTAAAGAAAGCTCTCTA -> GTGGAAGTAAAGAAAGCTCTCTAA
TGTGGGGCATGTGCTGAGATACGA -> GTGGGGCATGTGCTGAGATACGAG
TGTGGTATTCTCCAGAAGCTGGCT -> GTGGTATTCTCCAGAAGCTGGCTC
TGTGTAAGTCTACTATCTGATCCG -> GTGTAAGTCTACTATCTGATCCGA
TGTGTATAAGACAGCTATCCTGAC -> GTGTATAAGACAGCTATCCTGACA
TGTTAAATTCCAGCACGGCCTCTG -> GTTAAATTCCAGCACGGCCTCTGT
TGTTCAACAAGAAGTGAAGCAGGT -> GTTCAACAAGAAGTGAAGCAGGTT
TGTTGCCGCGAAGTGGGGTAGGCC -> GTTGCCGCGAAGTGGGGTAGGCCA
TGTTTTTGATATTTGCATAGCTTT -> GTTTTTGATATTTGCATAGCTTTT
TTAAAACATCTTGTCCTGTTAAAT -> TAAAACATCTTGTCCTGTTAAATT
TTAAAACGCCGGTTGTCCAGGAAG -> TAAAACGCCGGTTGTCCAGGAAGA
TTAAAATCCCTTAATAGAAAATTA -> TAAAATCCCTTAATAGAAAATTAA
TTAAACCCGTGTATTGACACTCTG -> TAAACCCGTGTATTGACACTCTGA
TTAAATTCCAGCACGGCCTCTGTG -> TAAATTCCAGCACGGCCTCTGTGG
TTAACATGACGTCGTGGAAGTTCT -> TAACATGACGTCGTGGAAGTTCTA
TTAACGCTTGATATCTCTAGGTTA -> TAACGCTTGATATCTCTAGGTTAC
TTAACTAATGACCCTCGGGTTCCC -> TAACTAATGACCCTCGGGTTCCCC
TTAACTCGCTGCAGCAGTTCTTAC -> TAACTCGCTGCAGCAGTTCTTACC
TTAAGCTCCGCAAAAAGAGTGTAT -> TAAGCTCCGCAAAAAGAGTGTATC
TTAATAGAAAATTAAAACATCTTG -> TAATAGAAAATTAAAACATCTTGT
TTAATCTCGCGGAGGTGCAAAGCT -> TAATCTCGCGGAGGTGCAAAGCTT
TTACACGACATGTCCGAGAACTAT -> TACACGACATGTCCGAGAACTATG
TTACCAGTAGTCTAGTAATAGACT -> TACCAGTAGTCTAGTAATAGACTA
TTACCGTTAGGATCACTTGTGTAA -> TACCGTTAGGATCACTTGTGTAAG
TTACCTCTCGAGGCGAGATACCAC -> TACCTCTCGAGGCGAGATACCACG
TTACCTTGCCCCCCGGAGGTCGAT -> TACCTTGCCCCCCGGAGGTCGATC
TTACGATGCGCCAACTTAACGCTT -> TACGATGCGCCAACTTAACGCTTG
TTACGCACAGAACGGAGTCCACAC -> TACGCACAGAACGGAGTCCACACG
TTACGCGGCAACGACGGGGATGAG -> TACGCGGCAACGACGGGGATGAGT
TTACGCTCTGCGGGGGACATTGGA -> TACGCTCTGCGGGGGACATTGGAC
TTACGGCAGGCTCTTCCAATACGG -> TACGGCAGGCTCTTCCAATACGGA
TTACTGGATTGAGACTCGACAAGC -> TACTGGATTGAGACTCGACAAGCT
TTAGCAGCACACTGAGGTTAGTGT -> TAGCAGCACACTGAGGTTAGTGTC
TTAGCCTAGTTAGGCAACATTGGA -> TAGCCTAGTTAGGCAACATTGGAG
TTAGGATCACTTGTGTAAGTCTAC -> TAGGATCACTTGTGTAAGTCTACT
TTAGGCAACATTGGAGTTGCTCGC -> TAGGCAACATTGGAGTTGCTCGCT
TTAGGCCTCGTCTGCACCATGTCT -> TAGGCCTCGTCTGCACCATGTCTT
TTAGTGGCTGACGAGTGTCTTAAA -> TAGTGGCTGACGAGTGTCTTAAAC
TTAGTGTCCGCAGAACCGTCTTTA -> TAGTGTCCGCAGAACCGTCTTTAG
TTATCACGATGCACCAAGACTTGC -> TATCACGATGCACCAAGACTTGCC
TTATCCAGGGCCACACAGTCTATC -> TATCCAGGGCCACACAGTCTATCC
TTATCCCAGTCCGATCCGAATCTA -> TATCCCAGTCCGATCCGAATCTAT
TTATGACCATCACTCCAAGCCCCC -> TATGACCATCACTCCAAGCCCCCG
TTATGTTGCCGCGAAGTGGGGTAG -> TATGTTGCCGCGAAGTGGGGTAGG
TTATTAAAATCCCTTAATAGAAAA -> TATTAAAATCCCTTAATAGAAAAT
TTATTCGAATAAGTGGACGGATCC -> TATTCGAATAAGTGGACGGATCCA
TTATTTCAGGCCCCAGACTATAAC -> TATTTCAGGCCCCAGACTATAACT
TTATTTCTTCTGGAACGCCATTAT -> TATTTCTTCTGGAACGCCATTATT
TTATTTTTAGGCCTCGTCTGCACC -> TATTTTTAGGCCTCGTCTGCACCA
TTCAACAAGAAGTGAAGCAGGTTC -> TCAACAAGAAGTGAAGCAGGTTCC
TTCACCATTGGGCACTGTCCCCGC -> TCACCATTGGGCACTGTCCCCGCT
TTCAGGCCCCAGACTATAACTTAG -> TCAGGCCCCAGACTATAACTTAGC
TTCAGTTCGTAACCTTCATAGGAC -> TCAGTTCGTAACCTTCATAGGACT
TTCATAGGACTAGGACGCCGGAAT -> TCATAGGACTAGGACGCCGGAATT
TTCATGGTTGCTTTCGTGTGGTAT -> TCATGGTTGCTTTCGTGTGGTATT
TTCATTACCAGTAGTCTAGTAATA -> TCATTACCAGTAGTCTAGTAATAG
TTCCAATACGGAGCTAGCGTTCTG -> TCCAATACGGAGCTAGCGTTCTGC
TTCCAGCACGGCCTCTGTGGGGCA -> TCCAGCACGGCCTCTGTGGGGCAT
TTCCATAAACATCATTCTTATTTC -> TCCATAAACATCATTCTTATTTCA
TTCCCCAGGCCCTTCGTAGAACCA -> TCCCCAGGCCCTTCGTAGAACCAC
TTCCCGCCGTCCTTGATTCACCAT -> TCCCGCCGTCCTTGATTCACCATT
TTCCGGTGGATCATTGATGCCAGG -> TCCGGTGGATCATTGATGCCAGGC
TTCCTGGTGGTGGTCTTTTGTCAT -> TCCTGGTGGTGGTCTTTTGTCATC
TTCGAATAAGTGGACGGATCCATG -> TCGAATAAGTGGACGGATCCATGC
TTCGATAAAATATCAACTGGACCA -> TCGATAAAATATCAACTGGACCAC
TTCGCTAGCTAAGTTGAATCTAGT -> TCGCTAGCTAAGTTGAATCTAGTC
TTCGTAACCTTCATAGGACTAGGA -> TCGTAACCTTCATAGGACTAGGAC
TTCGTAGAACCACGCTTGTATAGA -> TCGTAGAACCACGCTTGTATAGAC
TTCGTGTGGTATTCTCCAGAAGCT -> TCGTGTGGTATTCTCCAGAAGCTG
TTCTAAATCATATCACTAACCACC -> TCTAAATCATATCACTAACCACCG
TTCTACTCTCATAGAAAAACAGGC -> TCTACTCTCATAGAAAAACAGGCT
TTCTATCGGCTGAACTTTACGCTC -> TCTATCGGCTGAACTTTACGCTCT
TTCTCCAGAAGCTGGCTCAGAATC -> TCTCCAGAAGCTGGCTCAGAATCT
TTCTGCCGACTAATAACTTGTACA -> TCTGCCGACTAATAACTTGTACAA
TTCTGGAACGCCATTATTTTTAGG -> TCTGGAACGCCATTATTTTTAGGC
TTCTTACCGTTAGGATCACTTGTG -> TCTTACCGTTAGGATCACTTGTGT
TTCTTATTTCAGGCCCCAGACTAT -> TCTTATTTCAGGCCCCAGACTATA
TTCTTCAGTTCGTAACCTTCATAG -> TCTTCAGTTCGTAACCTTCATAGG
TTCTTCTGGAACGCCATTATTTTT -> TCTTCTGGAACGCCATTATTTTTA
TTGAATCTAGTCTTTCTTCAGTTC -> TGAATCTAGTCTTTCTTCAGTTCG
TTGACACTCTGACACTTAAAACGC -> TGACACTCTGACACTTAAAACGCC
TTGACGGTTACCTTGCCCCCCGGA -> TGACGGTTACCTTGCCCCCCGGAG
TTGACTCATCGCTCGATAACCGGG -> TGACTCATCGCTCGATAACCGGGG
TTGAGACTCGACAAGCTCTTGGAG -> TGAGACTCGACAAGCTCTTGGAGA
TTGATATCTCTAGGTTACGCGGCA -> TGATATCTCTAGGTTACGCGGCAA
TTGATATTTGCATAGCTTTTTCCG -> TGATATTTGCATAGCTTTTTCCGG
TTGATGCCAGGCAAACTGGCCTTA -> TGATGCCAGGCAAACTGGCCTTAA
TTGATTATCCAGGGCCACACAGTC -> TGATTATCCAGGGCCACACAGTCT
TTGATTCACCATTGGGCACTGTCC -> TGATTCACCATTGGGCACTGTCCC
TTGATTGGCAAGTAAAATCTCCTG -> TGATTGGCAAGTAAAATCTCCTGG
TTGCATAGCTTTTTCCGGTGGATC -> TGCATAGCTTTTTCCGGTGGATCA
TTGCCCCCCGGAGGTCGATCGGAG -> TGCCCCCCGGAGGTCGATCGGAGT
TTGCCGCGAAGTGGGGTAGGCCAA -> TGCCGCGAAGTGGGGTAGGCCAAC
TTGCCTCACAATCCGTGTGAACAG -> TGCCTCACAATCCGTGTGAACAGA
TTGCTAGCAACTATCTTCATTACC -> TGCTAGCAACTATCTTCATTACCA
TTGCTCGCTTATTCGAATAAGTGG -> TGCTCGCTTATTCGAATAAGTGGA
TTGCTGCCGACTACTCTCTTAACT -> TGCTGCCGACTACTCTCTTAACTA
TTGCTTTCGTGTGGTATTCTCCAG -> TGCTTTCGTGTGGTATTCTCCAGA
TTGGACAACATCGGGTTGGTACGA -> TGGACAACATCGGGTTGGTACGAT
TTGGACACACGAGCGGTGTGCGGG -> TGGACACACGAGCGGTGTGCGGGA
TTGGAGAACCTCACTAACGCGTCC -> TGGAGAACCTCACTAACGCGTCCG
TTGGAGTTGCTCGCTTATTCGAAT -> TGGAGTTGCTCGCTTATTCGAATA
TTGGATACCCATGATACACGCGTC -> TGGATACCCATGATACACGCGTCT
TTGGCAAGTAAAATCTCCTGGGAG -> TGGCAAGTAAAATCTCCTGGGAGC
TTGGGACTCACTAGTCGTATCAAG -> TGGGACTCACTAGTCGTATCAAGT
TTGGGCACTGTCCCCGCTATCTAG -> TGGGCACTGTCCCCGCTATCTAGT
TTGGTACGATTGCTAGCAACTATC -> TGGTACGATTGCTAGCAACTATCT
TTGTAATATCCGGTGTCCGACTGT -> TGTAATATCCGGTGTCCGACTGTG
TTGTACAAAACTTACGCACAGAAC -> TGTACAAAACTTACGCACAGAACG
TTGTACCTTTTTACACGACATGTC -> TGTACCTTTTTACACGACATGTCC
TTGTATAGACCGGCCGCACGTCAC -> TGTATAGACCGGCCGCACGTCACG
TTGTCATCTCCCTTGGACAACATC -> TGTCATCTCCCTTGGACAACATCG
TTGTCCAGGAAGATTGTGGAAGTA -> TGTCCAGGAAGATTGTGGAAGTAA
TTGTCCTGTTAAATTCCAGCACGG -> TGTCCTGTTAAATTCCAGCACGGC
TTGTGGAAGTAAAGAAAGCTCTCT -> TGTGGAAGTAAAGAAAGCTCTCTA
TTGTGTAAGTCTACTATCTGATCC -> TGTGTAAGTCTACTATCTGATCCG
TTGTTCAACAAGAAGTGAAGCAGG -> TGTTCAACAAGAAGTGAAGCAGGT
TTTAACTCGCTGCAGCAGTTCTTA -> TTAACTCGCTGCAGCAGTTCTTAC
TTTACACGACATGTCCGAGAACTA -> TTACACGACATGTCCGAGAACTAT
TTTACGATGCGCCAACTTAACGCT -> TTACGATGCGCCAACTTAACGCTT
TTTACGCTCTGCGGGGGACATTGG -> TTACGCTCTGCGGGGGACATTGGA
TTTAGCCTAGTTAGGCAACATTGG -> TTAGCCTAGTTAGGCAACATTGGA
TTTAGGCCTCGTCTGCACCATGTC -> TTAGGCCTCGTCTGCACCATGTCT
TTTATCCCAGTCCGATCCGAATCT -> TTATCCCAGTCCGATCCGAATCTA
TTTCAGGCCCCAGACTATAACTTA -> TTCAGGCCCCAGACTATAACTTAG
TTTCCGGTGGATCATTGATGCCAG -> TTCCGGTGGATCATTGATGCCAGG
TTTCGTGTGGTATTCTCCAGAAGC -> TTCGTGTGGTATTCTCCAGAAGCT
TTTCTTCAGTTCGTAACCTTCATA -> TTCTTCAGTTCGTAACCTTCATAG
TTTCTTCTGGAACGCCATTATTTT -> TTCTTCTGGAACGCCATTATTTTT
TTTGATATTTGCATAGCTTTTTCC -> TTGATATTTGCATAGCTTTTTCCG
TTTGCATAGCTTTTTCCGGTGGAT -> TTGCATAGCTTTTTCCGGTGGATC
TTTGCTGCCGACTACTCTCTTAAC -> TTGCTGCCGACTACTCTCTTAACT
TTTGTCATCTCCCTTGGACAACAT -> TTGTCATCTCCCTTGGACAACATC
TTTGTTCAACAAGAAGTGAAGCAG -> TTGTTCAACAAGAAGTGAAGCAGG
TTTTAACTCGCTGCAGCAGTTCTT -> TTTAACTCGCTGCAGCAGTTCTTA
TTTTACACGACATGTCCGAGAACT -> TTTACACGACATGTCCGAGAACTA
TTTTAGGCCTCGTCTGCACCATGT -> TTTAGGCCTCGTCTGCACCATGTC
TTTTCCGGTGGATCATTGATGCCA -> TTTCCGGTGGATCATTGATGCCAG
TTTTGATATTTGCATAGCTTTTTC -> TTTGATATTTGCATAGCTTTTTCC
TTTTGTCATCTCCCTTGGACAACA -> TTTGTCATCTCCCTTGGACAACAT
TTTTTACACGACATGTCCGAGAAC -> TTTTACACGACATGTCCGAGAACT
TTTTTAGGCCTCGTCTGCACCATG -> TTTTAGGCCTCGTCTGCACCATGT
TTTTTCCGGTGGATCATTGATGCC -> TTTTCCGGTGGATCATTGATGCCA
TTTTTGATATTTGCATAGCTTTTT -> TTTTGATATTTGCATAGCTTTTTC